   ##            
  #  #           
  #  #  #####    
  #  # #..   #   
  # ####..##o##  
  #  o o.O     # 
  # #o #O.# o# # 
 ##o#  #..#  # # 
#   #o #O.# o# # 
# # #  o..#  # # 
# #o#o #..o  #  #
#   #  #..#   # #
# #@# o#O.#o# # #
#  o#  #..#   # #
 #   o o o ###  #
  ###   #      # 
     ### ######  
Title: Pattern-oster
