    ##    ###     
####  ####   #    
# o  o     o ###  
# #   # ### #   # 
#  o   o # oo o # 
 ##  ## o@o     # 
  #o ##  # oo oo #
  #    o  ## ##  #
 ### #o##  ...# # 
 #  ..O.O..##.# # 
 # #..O.....O.# # 
 #   ########   # 
  ###        ###  
Title: Carousel
