       ##    
     ##  ### 
   ## o o   #
  #   #..#o #
  # oo#O.#  #
  #   ....o #
  # # .#.#  #
 # o##o#.#o #
 # @o    .o #
  #  #  ##  #
   #####  ## 
Title: Spade
