       ###     
##### #   ###  
#   ## o o  #  
# # ##    # #  
# #..o o ## #  
#  .o# o#   #  
###..# o @o #  
  #OO# o # ##  
  #..#   # #   
  #..##### ##  
  #.O#   o  #  
  #..# o    #  
  ##.### ##### 
  # o      o # 
  #   ####   # 
  #####  ##### 
Title: Salamandar v3
