 ### ####      
#   ##   # ### 
# o   o o #   #
# o #  .o #   #
 ##  ##.#  o # 
# ##o##.###. # 
#   O.......o# 
#    ##.##   # 
##o####.#####  
#  o # . #   # 
#  #  OOo    # 
#  o # @ # o # 
# o   ### #  # 
 ##   #   ###  
   ###         
Title: Saturnine
