 ################
##              ##
#  ############  #
# #            # #
# # ooo o o   @# #
#  #   ###   oo# ##
## o ##   #   o o #
 ##   # #  ####   #
  ###..  #     #  ###
    ##    .. # .# o ####
     # #### ## .# #.#  #
     #    # ###O o .#  ##
     #### #    .# #.    #
        #   ## .###.##  #
        ######          #
             #   #  #   #
             ############
