 ######
 #    #
 #    ###
 ##O#   #
## . ## #
#     # ##
# #.#  o #
# o.###o #
### ##   #
  #   oo@#
 ##..##  #
 #   #####
 #   #
 #####
