      #####
     ###  ##
    ## o   ##
   ## o  Oo ##
  ## o.#.o.o ##
 ## o.o. .o.o ##
## o.o. . .o.o ##
#  Oo. O O .# o##
#   . . @ . .   #
##o #. O O .oO  #
## o.o. . .o.o ##
 ## o.o. .o.o ##
  ## o.o.#.o ##
   ## oO  o ##
    ##   o ##
     ##  ###
      #####
