  ####  ####
  #  ####  ####
###     o o   #
#    # o  O...##
# o # #### #.. #
##   #         #
 # oo oo@ #...##
 #   #  #######
 ####   # #
    #####
