     #####
######   #
#  o     #
#  o### ##
##.o. . .#
 # o#    #
 # @######
 #  #
 ####
