  ########
 ##.... @#
 #  # .  #
## #  # ##
#  #o # #
# o   # ##
###o ##  #
  #   oo #
  #   #  #
  ########
