 #############
 #     @     #
 #OO.OOOOO.OO#
 #  o     o  #
 #   # ###   #
 #####   #####
######## ######
#             #
#OO.OOOOOOO.OO#
#  o       o  #
#   #######   #
#####     #####
