    ####
  ###  ###
###      ##
# oo#ooo@ ##
#     #    #
# ###  #ooo#
#    #   # #
####   .## #
   ####.## ##
    ## .##  #
    ##...   #
    #  .#####
    #  .#
    #####
