     #####
     # @ #
     # o #
     # o #
    ## o ##
#####.O.O.#####
#    O. .O    #
# ooo. # .ooo #
#    O. .O    #
#####.O.O.#####
    ## o ##
     # o #
     # o #
     #   #
     #####
