 ###############
##  ....#      ##
#  # #     ###  #
#   ....# #   # #
#      # o o  # #
##     # o@o #  #
 ####### o o #  #
  ##O#   o o  # #
   ### ####   # #
    ##     ###  #
     #####     ##
         #######
