          ####
          #  ###
          #    #
   ########oo  #
   #       o  ##
   # #### oo ##
####....# o  #
#   ...# oo  #
#  #...# o ###
# @## ## o #
#         ##
#  #  #####
#######
