   #    #    #    #    #
   #####################
  ##    #    #    #    ##
### .oo. .oo. .oo. .oo. ###
 # .O  O.O  O.O  O.O  O. #
 # o ## o ## o ## o ## o #
 # o ## o ## o ## o ## o #
 # .O  O.O  O.O  O.O  O. #
### .oo. .oo.@.oo. .oo. ###
 # .O  O.O  O.O  O.O  O. #
 # o ## o ## o ## o ## o #
 # o ## o ## o ## o ## o #
 # .O  O.O  O.O  O.O  O. #
### .oo. .oo. .oo. .oo. ###
  ##    #    #    #    ##
   #####################
   #    #    #    #    #
