######
#    #
# .o #
# OO #
##o. #
 #  ####
 # ##  #
 #  #  #
 #     #
 #.OOo@#
 #  #  #
 #######
