 ####
 #  #####
 #  o o #
 #O . . #
 #  ########
 #      #  #
 #### o    #
 #   #o### #
 # @o#   # ####
 # oo oo   #  #
 #   # ## o O #
## ###.....#. #
#...  ###o# . #
# o o       . #
########  #####
       ####
