 ######
 #    #####
 # o O#   #
 #  O O o #
###O . O  #
# O .@. O #
#  O . O###
# o O O  #
#   #O o #
#####    #
    ######
