           ####
         ###  #
  ######## oo ##
###   #   .O.o #
#  oo # #....o #
# o.. # o o    #
##oO. ##  ######
 # ..o## ###   #
 ## .  #    o# #
  # #o   @#  . ##
  #   ### ##o.. #
  ######  ## .Oo##
  #    o o # ..o #
  # o....# # oo  #
  # o.O.   #   ###
  ## oo ########
   #  ###
   ####
