 ###############
##  #   #   #  ##
#   OO.. ..OO   #
#  O   ooo   O  #
##O .### ###. O##
# O ## o@o ## O #
# . #       # . #
# .o#o ### o#o. #
## o   # #   o ##
# .o#o ### o#o. #
# . #       # . #
# O ## o o ## O #
##O .### ###. O##
#  O   ooo   O  #
#   OO.. ..OO   #
##  #   #   #  ##
 ###############
