  ##### # #####
 ## # ##### # ##
 #  #   #   #  #
## oO o   o Oo ##
#   ..O# #O..   #
###O..  #  ..O###
 # o Oo # oO o #
 #   #  O  #   #
### ###O O### ###
 #   #  O  #   #
 # o Oo # oO o #
###O..  #  ..O###
#   ..O#@#O..   #
## oO o   o Oo ##
 #  #   #   #  #
 ## # ##### # ##
  ##### # #####
