      #######
     ##     ##
     #  O.O  #
     # #o o# #
 #####  O.O  #####
##   ##     ##   ##
#  #  ###.###  #  #
# OoO # oOo # OoO #
# . . ..o@o.. . . #
# OoO # oOo # OoO #
#  #  ###.###  #  #
##   ##     ##   ##
 #####  O.O  #####
     # #o o# #
     #  O.O  #
     ##     ##
      #######
