   ## ##
 ##  #  ##
 ##     ##
#  Oo#oO  #
#  o...o  #
 # #.@.# #
#  o...o  #
#  Oo#oO  #
 ##     ##
 ##  #  ##
   ## ##
