             ###
      #################
  ######   ##   ##   ######
####   # oo   #   oo #   ####
#  #oo     #.. ..#     oo#  #
#      ### #.###.# ###      #
#O ##### ### #O# ### ##### O#
#           ..@..           #
#O ##### ### #O# ### ##### O#
#      ### #.###.# ###      #
#  #oo     #.. ..#     oo#  #
####   # oo   #   oo #   ####
  ######   ##   ##   ######
      #################
             ###
