#############
#     o   . #
#.o o### Oo #
# OO ## .O  #
#  .o#..o o #
# # .o.o### #
#o##..@..##o#
# ###o.o. # #
# o o..#o.  #
#  O. ## OO #
# oO ###o o.#
# .   o     #
#############
