###########
#    O    #
# oo ## o #
#  o..#oo #
# ##O.O.  #
#O#..@..#O#
#  .O.O## #
# oo#..o  #
# o ## oo #
#    O    #
###########
