    #####
 ####   #
 # @ o# #
 # #....#
##o o o #
#  ### ##
#      #
#####  #
    ####
