####
#  #########
#    ##    #
# ooo#     #
##...# #ooo#
 #...# #...#
 #ooo  #...##
 #    ##ooo #
 ####### @  #
       ######
