 ####
 #  #
## .###
#  .o #
#O O  ##
# o.oo #
#  .   #
###O####
  #@#
  ###
