   ####
####  #
#     ####
# o #  . ##
#  #   .  #
## #oo#.  #
##    #####
# @ ###
#   #
#####
