 ###############
## o.       .o ##
#  # ####### #  #
# #           # #
#  .OOOo#oOOO.  #
###     #     ###
  # ####@#### #
  #           #
  #############
