 # ## ####
## #  #  ###
   # ##o   #
#### # O # #
#    # O # #
  #### O # #
###    . # #
#@#.OOOOo# #
#        # #
# #####  # #
#      ##  #
######    ##
     ######
