  ######
  #  . ##
  # #O  #
  # o.o #
  ## O. #
 ## o.@ #
## # .o #
#  oo.# #
#      ##
########
