    #####
#####   #
#    o  #
#  o#o#@#
### #   #
  # ... #
  ###  ##
    #  #
    ####
