  #####
  # . ##
### o  #
# . o#@#
# #o . #
#  o ###
## . #
 #####
