   ##########
####    ##  #
#  ooo....o@#
#      ###  #
#   #### ####
#####
