      ###
##### #.#
#   ###.#
#   o #.#
# o  o  #
#####@# #
    #   #
    #####
