     ####
######  #
#       #
#  ... .#
##o######
# o  #
#   o###
##  o  #
 ## @  #
  ######
