  #########
### @ #   #
# O o O.. #
#   o #   #
####O#  ###
 #     ##
 #   ###
 #####
