########
#      #
# .OOo@#
#      #
#####  #
    ####
