 ####
 #  ####
 #     ##
## ##   #
#. .# @o##
#   # oo #
#  .#    #
##########
