  ####
### @#
#  o #
#  O.#
#  O.#
#  o #
###  #
  ####
