   ###
   #@#
 ###o###
##  .  ##
#  # #  #
# #   # #
# #   # #
# #   # #
#  # #  #
## o o ##
 ##. .##
  #   #
  #   #
  #####
