       ####
      ##  ###
####  #  o  #
#  #### o o #
#   ..# #o  #
#  #   @  ###
## #..# ###
 # ## # #
 #      #
 ########
