##########
#   ##   #
# o  o@# #
#### # o #
   #.#  ##
 # #.# o#
 # #.   #
 # #.   #
   ######
