  ######
  #    #
  #    #
#####  #
#   #.#####
#   o@o   #
#####.#   #
   ## ## ##
   #   o.#
   #   ###
   #####
