Title: from (Original 47)
     ####
 #####  #
 #     o#######
## ## ..#  ...#
# o oo#o  @   #
#        ###  #
#######  # ####
      ####
