      #####
      #.  #
      #.# #
#######.# #
# @ o o o #
# # # # ###
#       #
#########
