######
#    ####
#    ...#
#    ...#
######  #
  #  #  #
  # oo ##
  # @o  #
  # oo  #
  ## o# #
   #    #
   ######
