      ######
      #    #
  ##### .  #
###  ###.  #
# o  o  . ##
# @oo # . #
##    #####
 ######
