###########
#     #   ###
# o@o # .  .#
# ## ### ## #
# #       # #
# #   #   # #
# ######### #
#           #
#############
