 #######
 #     #
## ###o##
#.o   @ #
# .. #o #
#.##  o #
#    ####
######
