      #####
      #   ##
      # o  #
######## #@##
# .  # o o  #
#        o# #
#...#####   #
#####   #####
