#####
#   ##
# o  #
## o ####
 ###@.  #
  #  .# #
  #     #
  #######
