########
#      #
# oOOO #
# O  O #
# O  O #
# OOO. #
#     @#
########
