####
#  ###
#    ###
#  oO@ #
### .# #
  #    #
  ######
