 #######
 #     #
 # .o. #
## o@o #
#  .o. #
#      #
########
