####
#  ####
#.Oo  #
# .o# #
## @  #
 #   ##
 #####
