#######
#     #
#. .  #
# ## ##
#  o #
###o #
  #@ #
  #  #
  ####
