######
#... #
#  o #
# #o##
#  o #
#  @ #
######
