     ####
 # ###  #
 # #    #
 # #  # #
 # #o #.#
 # #  # # #
 # #o #.# #
   #  # # #
####o #.# #
# @     # #
#   #  ## #
########
