 ######
##    #
#  ## #
# # o #
#  O .#
## #@##
 #   #
 #####
