   ####
   #  #
   #@ #
####o.#
#   o.#
# # o.#
#    ##
######
