  ####
###  ####
#       #
#@oOOO. #
#       #
#########
