 ####
 #  ###
 # oo #
##... #
#  @o #
#   ###
#####
