#####
#   ##
# #  #
#@oO.##
##  . #
 # o# #
 ##   #
  #####
