 #### ####
##  ###  ##
#   # #   #
#  O. .O  #
###o   o###
 #   @   #
###o   o###
#  O. .O  #
#   # #   #
##  ###  ##
 #### ####
