 ########
 #  @   #
 # o  o #
### ## ###
#  o..o  #
#   ..   #
##########
