  #####
  #   #
  # # #######
  #  O  #   #
  ## ##   # #
  #     #O  #
### # # # ###
#  O#o+   #
# #   ## ##
#   #  O  #
####### # #
      #   #
      #####
Title: Lockdown
