 #####
 # @ #
 #   #
###o #
# ...#
# oo #
###  #
  ####
