  ####
###  #
#    ###
# # . .#
# @ ...####
# # # #   ##
#   # oo   #
#####  o o #
    ##o # ##
     #    #
     ######
