 #####
##   ####
#  ooo  #
# #   o #
#   o## ##
###  #.  #
  #  #   #
 ##### ###
 #   # ##
 # @....#
 #      #
 #   #  #
 ########
