############
#          #
# ####### @##
# #         #
# #  o   #  #
# oo #####  #
###  # # ...#
  #### #    #
       ######
