###########
#  .  #   #
# #.  @   #
#  #..# #######
##  ## oo o o #
 ##           #
  #############
Title: from (Original 18)
