 #########
##   #   ##
#    #    #
#  o # o  #
#   O.O   #
####.@.####
#   O.O   #
#  o # o  #
#    #    #
##   #   ##
 #########
