      ####
#######  #
# o      ##
# o#####  #
#  @#  #  #
## ##..   #
#  # ..####
# o  ###
# o###
#  #
####
