#######
#. #  #
#  o  #
#. o#@#
#  o  #
#. #  #
#######
