######
#  @ #
#  # ##
# .#  ##
# .ooo #
# .#   #
####   #
   #####
