#####
#   #
# @ #
# oo###
##. . #
 #    #
 ######
