    ####
  ###  ##
 ## o   #
## o  # #
# @#oo  #
# ..  ###
# ..###
#####
