######## #####
#  #   ###   #
#      ## o  #
#.# @ ## o  ##
#.#   # o  ##
#.#    o  ##
#. ## #####
##    #
 ######
