#####  #####
#   ####.. #
# ooo      #
#   o#  .. #
### @#  ## #
  #  ##    #
  ##########
