####
#  ####
# . . #
# oo#@#
##    #
 ######
