  ####
  #  #
  #  ####
###o.o  #
#  .@.  #
#  o.o###
####  #
   #  #
   ####
