        ####
#########  #
#   ## o   #
#  o   ##  #
### #. .# ##
  # #. .#o##
  # #   #  #
  # @ o    #
  #  #######
  ####
