  ######
  #    #
  #  o #
 ####o #
## o o #
#....# ##
#     @ #
##  #   #
 ########
