  ######
  #    ##
 ## ##  #
 # oo # #
 # @o # #
 #    # #
#### #  #
#  ... ##
#     ##
#######
