  ####
 ##  #####
 #  o  @ #
 #  o#   #
#### #####
#  #   #
#    o #
# ..#  #
#  .####
#  ##
####
