#####
#   ###
# .   ##
##O#o  #
# .# o #
# @## ##
#     #
#######
