  #########
###   #   #
# O o . . #
#   o ## ##
####O#   #
 #  @  ###
 #   ###
 #####
