 #####
##   #
#    #####
#  #.#   #
#@ #.# o #
#  #.#  ##
#    #  #
##  ##oo#
 ##     #
  #  ####
  ####
