  ######
  #    #
  # ##@##
### # o #
# ..# o #
#       #
#  ######
####
