 #########
 #    #  #
## o#o#  #
#  .o.@  #
#  .#    #
##########
