# #####
  #   #
###oo@#
#   ###
#     #
# . . #
#######
