#####   ####
#   ##### .#
#       o  ########
###  #### .o    @ #
  #  #  #  ####   #
  ####  ####  #####
