  ####
 ##  #
##@o.##
# oo  #
# . . #
###   #
  #####
