 #######
 #  . .###
 # . . . #
### #### #
#  @o  o #
#  oo  o #
####   ###
   #####
