########
#      #
# o oo ########
##### @##. .  #
    #o  # .   #
    #   #. . ##
    #o# ## # #
    #        #
    #  ###  ##
    #  # ####
    ####
