     ###
######@##
#    .O #
#   #   #
#####o# #
    #   #
    #####
