####     #####
#  ###   #   ##
#    #   #o o #
#..# ##### #  #
#  @    # o o #
#..#         ##
##   #########
 #####
