###########
#    .##  #
# oo@..oo #
#   ##.   #
###########
