########
# @ #  #
#      #
#####o #
    #  ###
 ## #o ..#
 ## #  ###
    ####
