 ######
##    #
#   o #
#  oo #
### .#####
  ##.# @ #
   #.  o #
   #. ####
   ####
