######
#    ##
# o o ##
## oo  #
 # #   #
 # ## ##
 #  . .#
 # @. .#
 #  ####
 ####
