 ####
 #  #######
 #o @#   .#
## #oo   .#
#  o  ##..#
#   # #####
###   #
  #####
