   ####
 ###  #####
 # oo #   #
 # o . .oo##
 # .. #. o #
### #OO .  #
#  . OO# ###
# o .# .. #
##oo.@. o #
 #   # oo #
 #####  ###
     ####
