#####
# @ #
#...#
#ooo##
#    #
#    #
######
