####
# @###
#.O  #####
#..#oo o #
##       #
 # # ##  #
 #   #####
 #####
