#####
#   ###
#. .  #
#   # #
## #  #
 #@oo #
 #    #
 #  ###
 ####
