 ####
##  ###
#     #
#.OOo@#
#   ###
##  #
 ####
