######
#   .#
# ## ##
#  oo@#
# #   #
#.  ###
#####
