#######
#     #
#@ooo ##
#  #...#
##    ##
 ######
