#####
#.  ##
#@oo #
##   #
 ##  #
  ##.#
   ###
