####
#  #######
#  . ## .#
# o#    .#
## ## # .#
 #    #  #
 #### #  #
  # @o ###
  # oo #
  #    #
  ######
