#######
# @#  #
#.o   #
#. # o##
#.o#   #
#. # o #
#  #   #
########
