   #####
  ##   #
###  # #
#    . #
#  ## #####
#  . . #  ##
#  # @ o   ###
#####. #  o  #
    ####  o  #
       ## o ##
        #  ##
        #  #
        ####
