  ####
  #  #
  # o####
###. .  #
# o # o #
#  . .###
####o #
   # @#
   ####
