 #####
 #   #
##   ##
# ooo #
# .+. #
#######
