#######
#  O  #
#     #
## # ##
 #o@.#
 #   #
 #####
