####
#  ###
# oo #
#... #
# @o #
#   ##
#####
