 #####
##   ##
#  o  ##
# o o  ##
###o# . ##
  # # .  #
 ## ##.  #
 # @  . ##
 #   #  #
 ########
