#######
#     #####
# oo#@##..#
# #       #
#  o # #  #
#### o  ..#
   ########
