     ####
     # @#
     #  #
###### .#
#   o  .#
#  oo# .#
#    ####
###  #
  ####
