###### #####
#    ###   #
# oo     #@#
# o #...   #
#   ########
#####
