  ####
  #  #    #####
  #  #    #   #
  #  ######.# #
####  o    .  #
#   oo# ###.# #
#   #   # #   #
######### #@ ##
          #  #
          ####
