  ####
###  ####
#     o #
# #  #o #
# . .#@ #
#########
