## ####
####  ####
 # o o.  #
## #  .o #
#   ##.###
#  o  . #
# @ #   #
#  ######
####
