  ####
###  #####
#  o  @..#
# o    # #
### #### #
  #      #
  ########
