 ####
 #  ######
##    o  #
# .# o   #
# .#o#####
# .@ #
######
