####
#. ##
#.@ #
#. o#
##o ###
 # o  #
 #    #
 #  ###
 ####
