 #####
##. .##
# O O #
#  #  #
# o o #
## @ ##
 #####
