###########
#....#    #
#  #   oo #
#  @  ##  #
#     ##o #
######  o #
     #    #
     ######
