 ###########
##.......  #
# ooooooo@ #
#   # # # ##
# # #     #
#   #######
#####
