   ####
   #  #
 ###  #
##  o #
#   # #
# #oo ######
# #   #   .#
#  o  @   .#
###  ####..#
  ####  ####
Title: from (Original 47)
