#######
#     #
# # # #
#. oO@#
#   ###
#####
