 #######
## ....##
#   ######
#   o o @#
###  o o #
  ###    #
    ######
