#####
#   ###
#  o  #
##O . #
 #   @#
 ######
