     #####
   ###   #
####.....#
# @ooooo #
#     # ##
#####   #
    #####
