########
#  ... #
#  ### ##
#  # o  #
## #@o  #
 # # o  #
 # ### #####
 #         #
 #   ###   #
 ##### #####
