#########
# @ #   #
# o o   #
##o### ##
#  ...  #
#   #   #
######  #
     ####
