####  ####
#  ####  #
#  #  #  #
#  #    o##
#  . .#o  #
#@ ## # o #
#   . #   #
###########
