 ####
##  ###
#@o   #
### o #
 #  ######
 #  o....#
 #  # ####
 ## # #
 # o# #
 #    #
 #  ###
 ####
Title: from (Boxxle 43)
