##########
# @ .... #
#   ####o##
## #  o o #
 # o      #
 #   ######
 #####
