##############
#      #     #
# o@oo # . ..#
## ## ### ## #
 # #       # #
 # #   #   # #
 # ######### #
 #           #
 #############
