  #######
###     #
# o o   #
# ### #####
# @ . .   #
#   ###   #
##### #####
