#####
#   ####
# # # .#
#    o ###
### #o.  #
#   #@   #
# # ######
#   #
#####
