##########
#        #
# ##.### #
# # oo . #
# . @o## #
#####    #
    ######
