######
#    #
# #@ #
# oO #
# .O #
#    #
######
