###### ####
#     #    #
#.##  #o##  #
#   #     #  #
#o  # ###  #  #
# #      #  # #
# # ####  # # #
#. @    o O . #
###############
Title: reduced (Mas Sasquatch 23)
