#####
# @ ####
#      #
# o oo #
##o##  #
#   ####
# ..  #
##..  #
 ###  #
   ####
