######
# @  #
# o# #
# o  #
# o ##
### ####
 #  #  #
 #...  #
 #     #
 #######
