#############
#.# @#  #   #
#.#oo   # o #
#.#  # o#   #
#.# o#  # o##
#.#  # o#  #
#.# o#  # o#
#..  # o   #
#..  #  #  #
############
Title: reduction of (Revenge 306)
