########
#      #
# #### #
# #...@#
# ###o###
# #     #
#  oo o #
####   ##
   #.###
   ###
