#####
#   #
# . #
#.@.###
##.#  #
#  o  #
# o   #
##oo  #
 #  ###
 #  #
 ####
