 ######
 # .  #
##o.# #
#  O  #
# ..###
##o # #####
## ## #   #
#  #### # #
#   @ o o #
##  #     #
 ##########
