 #####
 #   #
 # . #
## O #
#  O##
#  @##
## o #
 #   #
 #####
