 #### ####
 #  ###  ##
 #      @ #
##..###   #
#      #  #
#...#o  # #
# ## oo o #
#  o    ###
####  ###
   ####
