    #####
#####   ####
#     #    #
#  #.....  #
##  ## # ###
 #oo@ooo #
 #     ###
 #######
