 #########
 #       #
##@##### #
#  #   # #
#  #   o.#
#  ##o##.#
##o##  #.#
#   o  #.#
#   #  ###
########
