          ####      
       ####  ###### 
       #  # .##   # 
       #  o  #  # # 
 #######.O.OO#o## # 
 #        #     # ##
## ##o##### o  o#  #
#  # . O  ####  ## #
# ##oO Oo #   #  # #
# #  .....o@o    # #
# #   ##  ######## #
# ##  ##  #        #
#  ######## ########
##          #       
 ############       
Title: prefab #5
