 ##### #####        
##   ###   ######   
#  #  ##      o ##  
# oo   ##O###  o ## 
#  # o #...  #  o ##
# o# # # Oo# ##  o #
#    o #...#   #o  #
##  #####.## o    ##
# .#...##.### ##  # 
# O.O....O.. o##### 
# .#. .##.### ##### 
## # ####.#       # 
## o  ###O#o#oo o # 
#  ##   o@o    ## # 
# o o #o### # o   # 
#     #     ##    # 
################### 
Title: Crossed Swords version 10
