      #####      
     #     #     
    #  # #  #    
   #  #   #  #   
   # #  O  # #   
  #  # O O #  #  
 #  ##o.#.o##  # 
#  # o  #  o #  #
# # O  O.O .O # #
#  o ##. .## o  #
# # O. O.O  O # #
#  # o  #  o #  #
 #  ##o.#.o##  # 
  #  # O O #  #  
   # #  O  # #   
   #  # @ #  #   
    #  # #  #    
     #     #     
      #####      
Title: Egg
