###############
#   #     #   #
#  . O O@O  . #
##o##  Oo ##o##
#    #   # o  #
#  #O#####.#  #
# oO #   # .o #
##   #O.o#   ##
 ###     O ### 
 #  . O O o. # 
 # ## ###.## # 
 #    # #    # 
 ###### ###### 
Title: Butterfly #3
