 #####   ##### 
 #   #####   # 
##     O     ##
# OO##o.o##OO #
#  . # O # .  #
# OO #o.o# OO #
##   # . #   ##
 ### ## ## ### 
  #  ## ##  #  
  #    o    #  
  #### @ ####  
     #####     
Title: Figure eight
