####  ####
#  ####  #
# .    . #
#  ####o #
## #    ##
## .oO# ##
# O#o #  #
#@o    . #
#  ####  #
####  ####
Title: torch1
