  #########  
 ##   #   ## 
##  # # #  ##
#  # o.o #  #
# #  O .  # #
#   .#O# o  #
###.o#@#o.###
#  o.###.o  #
# #  . . .# #
#  #  o  #  #
##  #o#o#  ##
 ##   #   ## 
  #########  
Title: boxin10
