        ######      
    #####    ####   
 #### o  o##   @### 
## o  o # o ### o ##
#  o #o## # ### o  #
# #o.............. #
#  o ### #o####   ##
##   # o  o # ##  # 
 #####      #  #### 
     ########        
Title: line7
