 ######## 
 #   #  # 
## #o# o# 
#       # 
#  #O# o##
#  ..O   #
####.### #
#  ..O o #
#@ #.#  ##
# o    o# 
#  ###  # 
#### #### 
Title: tree12
