####       
#  ####### 
# oo o o ##
#  o@o #  #
## #O#  # #
#  O.   # #
# o#.#. # #
#   .. #  #
### O..  ##
  ######## 
Title: small cross9
