     #######
     #     #
    ##.Oo# #
    #  ..o #
#####o# o###
# o   # .#  
# #O O  o#  
#@ .. #  #  
###   ####  
  #####     
Title: teapot3
