     #####    
  ####   #    
  #  # o #    
  #. .@O######
 ##..O.. #   #
##  #O#    # #
#  ##.# oo#  #
# # o.    # ##
#   ## # o   #
###### o o o #
     #  ######
     ####     
Title: fork7
