###################
##               ##
 ##  o o.o.o o  ## 
  ##  o.o.o.o  ##  
   ## .o.o.o. ##   
    ## .o.o. ##    
     ## .o. ##     
      ## . ##      
       ##@##       
      ## . ##      
     ## .o. ##     
    ## .o.o. ##    
   ## .o.o.o. ##   
  ##  o.o.o.o  ##  
 ##  o o.o.o o  ## 
##               ##
###################                                     
Title: bowtie3
