####          
#  #####      
# o#...###    
#    ooo #####
# o#.O.  .#  #
#@ # o .O.#o #
##### ooo    #
    ## ...#o #
     ######  #
          ####
Title: slinky5
