  #########      
  #@   #  ####   
  # o  # oo  #   
  #  o o  #  #   
  ##o #.#   #### 
  ## ##.###    # 
  #  O......#  # 
  #  ##.##### ###
#### ##.##  # o #
#    o   #o   # #
# #  ##  o  #   #
# ########  #####
#        # ##    
########   #     
       #####     
Title: cross7
