 ####      
 #  #######
 #   o@#  #
 # #.#o   #
 # #O .#o #
## #. O  ##
#  .#o# ## 
#       #  
####   ##  
   #####   
Title: diode1
