   ########   ##### 
  ##   #  #####   # 
 ##    #  o       # 
 #  # ##   ##### ###
##. . .## ##  o    #
#   #      #@ o  # #
#   ..####  ####o# #
######## ## o      #
          #####   ##
              ##### 
Title: two piece7
