#####    
#   #####
#       #
##o# .o #
#. O #o##
#.o.o  # 
#.o.. ## 
#o ####  
#@ #     
####     
Title: handsaw1
