   ####     
   #  #     
####o.######
#   o.o #  #
# o  +     #
####oO###O #
#### .### ##
#   #.  # # 
#       # # 
#### #  # ##
   # ####  #
   #       #
   #  ######
   ####     
Title: small2
