######## 
#      ##
# @ # . #
# o o.o #
##.#o#o##
#  . .  #
# Oo# . #
##     ##
 ####### 
Title: seesaw8
