#################
#    ....    #  #
# #.  o@o.OO.   #
# #. O #o#   #o #
#   #. #  ####  #
#####o##      o #
    #  ## ####  #
    ## o o # ####
     #  o  #     
     ##    #     
      ######     
Title: raygun1
