        ####    
   ######  #####
#### .. oo #   #
#    Oo #    o #
#  # .## .## ###
## #O.##o### #  
 #     @     #  
## ###o##.O# ## 
#  ##. ##. #  # 
#     # oO o  # 
#  # oo .. #### 
####  ######    
   ####         
Title: fizzgig1
