####################
#     #  #...#@    #
# #       ....#    #
#  o  #   #....#   #
# ##o#### ##....#  #
# o   o  #  #...#  #
# oo #   #   # oo  #
###  ooo#   oo  o  #
# o  #  #    # o#  #
#   o#  #       o  #
#  #    #    #  #  #
####################
