              #####
     ##########   #
     #        #   #
     #  o o    oo #
     # ##### ## o #
     #oo   #o## o #
     # ### # ##o  #
###### ### o o    #
#....        ##   #
#....        ######
#....        #
###########@##
          ###
