################
#       #@ #   #
# # # # # o  oo#
# #...# #ooo   #
#  ...# # o  oo##
# ##.## # ##    #
# #...     o    #
# ## ###  #######
#    # ####
######
