####################
#..#    #          #
#.o  o  #oo  o## o##
#.o#  ###  ## ##   #
#  # o #  oo   o   #
# ###  # #  #o  ####
#  ## # o   #@ #   #
# o    o  ##.##  o #
#  # o# o# o     ###
#  #  #  #   ###   #
#  ######## #      #
#           #  #.#.#
##o########o#   ...#
#    .O  #    ##.#.#
# .O...O   o  .....#
####################

