    ######
 ####    #
 #    ## #
 # o     #
### #### ########
#  o   o ##  ...#
#   oo oo    ...#
#    o  o##  ...#
##@## ## ##  ...#
 ###  o  ########
 #   oo  #
 #    #  #
 #########
