####################
#@     #   #       #
## ### ##  #### # ##
#    # #  oo       #
#  # # # o # o ## ##
#     o #  #oo #   #
#  ###  #      ## ##
#..#.# o #  o #    #
#..#.#  o # ## oo  #
#....##   oo  o  # #
#.....##        #  #
####################
