   ########
   #   #  #
   #  o   #
 ### #o   ####
 #  o  ##o   #
 #  # @ o # o#
 #  #      o ####
 ## ####o##     #
 # o#.....# #   #
 #  o..OO. o# ###
##  #.....#   #
#   ### #######
# oo  #  #
#  #     #
######   #
     #####
