####################
#        #   #@ #  #
# oo  #oo# # #  ## #
#  # o o #oo #     #
## #  #  # # #  #  #
#   ##       #     #
#   # o #   #   #  #
# o #o #   #  o #..#
##o #  ####    #...#
#  o          #....#
#   #  #     #.....#
####################
