 #####
 #   #
##o# ###
#   o@ #
# #  # #
# #. . #
#   ####
#####
