    ####
 ####  #
## o   #
#  # #o#
#.@.   ##
## # #  #
 #      #
 #  #####
 ####