####
#  ####
#     #
#     #
### ###
# ooo ##
# ...@ #
####   #
   #####