  #####
###   #
# o # ##
# #  . #
#    # #
## #   #
 #@  ###
 #####
