 #####
##   ###
# . . .#
# # ## ##
#    oo@#
### # o #
  #   ###
  #####