    ####
#####  #
#   o  #
# O.#  #
## ## ##
#      #
# @#   #
#  #####
####
