 #####
 #   ##
##.#o ##
# o    #
#. .#o #
### @ ##
  # # #
  #   #
  #####
