   ####
####  #
# o   #
#  .# ##
## #.  #
# @  o #
#   ####
#####