 #####
##   ###
# . .  #
# # ## ##
#    oo@#
### #   #
  #   ###
  #####