    ####
 ####  #
## o   #
#  # #o#
#.@..  ##
## # #  #
 #   o  #
 #  #####
 ####