 #####
 #   #
##o# ###
#  .o@ #
# #  # #
# #..o #
#   ####
#####
