    #####
   ##   ##
  ## .#  #
 ##   @  #
##    #  #
#  o #####
# O ##
#  ##
####