   ####
####  #
# o o #
#  .# ##
## #.  #
# @  o #
#.  ####
#####