    ####
#####  #
#   O  #
# O.#  #
## ## ##
# o    #
# @#   #
#  #####
####
