 #####
 #   ##
## #o ##
# o    #
#. .#  #
### @ ##
  # # #
  #   #
  #####
