  #####
###   #
# o # ##
# #  . #
# .  # #
##o#.o #
 #@  ###
 #####
