  ####
 ##  #
## . ##
#@ooo #
#. .# #
# #   #
#   ###
#####

