    ####  
#####  ## 
#   o o ##
#   #.o. #
##  OO.#@#
 #   . o #
 #####  ##
     #### 
Title: cossack2
