   #####  
 ###   ###
 # o # O #
## oO.O  #
#  O   . #
#@  ###  #
##### ####
Title: loom1
