 #####    
##   #####
#  # o@o #
# #..#O  #
#  .   . #
## o.#.O #
 # o oo# #
 #####   #
     #####
Title: catkins5
