####   ####
#  #####  #
#    o@o  #
# O.o#O.O #
## . # . ##
 # . #o. # 
 ## oo  ## 
  #  #  #  
  #######  
Title: heart4
