##########
#@ O.##  #
# o   o  #
###O..#  #
  #  o  ##
  # .#. # 
  # o o # 
  ####  # 
     #### 
Title: fretsaw1
