##########
#   #    #
# #o. .# #
#@#. O # #
# # O .# #
# #OoOo# #
# o      #
####  ####
   ####   
Title: osmosis1
