#####     
#   ####  
# #o   ###
# #.OoO  #
# # .O # #
#  . o.#@#
###  o # #
  ####   #
     #####
Title: bigt2
