  ######## 
  #   #  # 
 ##o#   .##
## .O #   #
#  .O Oo# #
#   . #@o #
#  # ##o###
####    #  
   ######  
Title: flagon1
