#####    
#   #####
# # o o #
# oo. O@#
# #  OO #
# ### O##
#  # .O #
##  . . #
 ##     #
  #######
Title: canine4
