 #####      
 #   #####  
 #     o@#  
 ## ##.#O###
### # o  o #
# o .o. .# #
#   o ##o# #
###.#.  .  #
  #   ######
  #####     
Title: bola1
