      #####
 ######   #
 #   # o  #
##  o..#o #
#  #OO.   #
#@# O.O#  #
#   ##   ##
### o  ### 
  ###  #   
    ####   
Title: clasp1
