 #######
 #  O  #
 #  @  #
 ##o#.##
 #  #  #
 # o#. #
 #  #  #
## ## ##
#  O O #
#   O  #
###   ##
  #####
