           #####
          ## . ##
         ##.o o.##
         # o O o #
         #. O O .#
         # o O o #
         ##.o o.##
 #######  ## . ##  #######
##     ##  ## ##  ##     ##
# .o.o. #   # #   # o.o.o #
# o.o.o ##### ##### .o.o. #
# .o o.             o.@.o #
# o.o.o ########### .o.o. #
# .o.o. #         # o.o.o #
##     ##  #####  ##     ##
 #######   #OOO#   #######
           #####
