         #
    #  #####
  #####    ####
  #   ..oo #  #
  # o o .#@#o ##
 #### # O##   #
 #   #  O  #o.#
## o##  .    . #
 # o.OO.#.OO.o #
 # .    .  ##o ##
  #.o#  O  #   #
  #   ##O # ####
 ## o# #. o o #
  #  # oo..   #
  ####    #####
     #####  #
       #
