           #####
############   #######
#     # # ## # # #   #
# # #o  o  # .o  o # ##
#  ..O.OO O@O OO.O..  #
## # o  o. #  o  o# # #
 #   # # # ## # #     #
 #######   ############
       #####
