       ####
########  #
#@ o o oo ###
#  ....O.O  #
## ### ..O# #
 #oo  # .O  #
 # # o #.O# #
 #   o #..  #
 ##  o    ###
  ### #o#.#
   # o o  #
   #     ##
   #######
