   ###   ###
   #  ###  #
  #    #    #
##  ooo.ooo  ##
#  .# . . #.  #
#  . # o # .  #
 # .o #.# o. #
 ##o .o@o. o##
 # .o #.# o. #
#  . # o # .  #
#  .# . . #.  #
##  ooo.ooo  ##
  #    #    #
   #  ###  #
   ###   ###
