 #########################
 #  #  #  #  #  #  #  #  #
 # o#o # o#o # o#o # o#o #
 #  #  #  #  #  #  #  #  #
 # o#o # o#o # o#o # o#o #
 #  #  #  #  #  #  #  #  #
 ## # ### # ### # ### # ##
 #  #  #  #  #  #  #  #  #
 #  o  #  o  #  o  #  o  #
## ### # ### # ### # ### ##
#   #  #  #  #  #  #  #   #
#   #  o  #  o  #  o  #   #
##  # ### # ### # ### #  ##
 #...........+...........#
 #########   #   #########
         #  ###  #
         #### ####
Title: Parallel Logic 2
