         ####
   #######  ####
   #         o ##
####o  ###.###  ##
#   o #  #.#  #  #
# # o #   .  @ # #
# #   #..###   # #
# # o#....  #  # #
# #  #...#o  # # #
# #o # ## oo o # #
# #  # .O    ##  #
# #oo## #  ##   ##
# #     ###   ###
#  ####o    ###
##      #####
 ########
