            ####
    #####   #  #####
   ##   #   #      #
   #  # ##### # #  #
   # # o o o o #  ##
   # #       #  # #
   #  ######o## # #
####  # O  #  # # #
#   o # .. o  # # #
# # # #O...# #  # #
# .OOO#. ..#   ## ##
##O....O.O  o #    #
 ##O ##.##### # o  #
  ##  #     o  # # #
   ##@ #.#o o o o# #
    ##    o o  #   #
     ##  ###########
      ####
