        ####
#########  #
#          #
# #O### #  #
#  o   # # #
#O#O##  #  #
#  o  #  # #
#  O#  # # #
#  o # # # ##
###o. . . . #
  #@####### #
  #         #
  ###########
