    ####
   ##  ####
   # o   .########
   # o # .   o o #
#### ### .#### # #
#  ....#o.#  # # #
# #. o # .#o # # #
#  ##  ooo@o # # #
##   ##  #   # # #
 ###   #  ## # # #
   ### # ...     #
     # #oO Oo#  ##
     # # ...o ###
     # oo #   #
     #   ######
     ##### 
