#####       ###
#  ###############
# o   O @ O  #   #
#  # O O O O     #
## #  O . O  # ###
 # # O O O O # #
 # #  O . O  # #
 # # O O O O # #
## #  O . O  # ##
## ###########  #
# o           o #
#   ##########  #
#####       #####
