 ###########
##         #
#  #######o##
# #       o ###
# #...OOO.O.@ #
# #       o # #
#  #######o#  #
##        o  ##
 ########   ##
        #####
