      ####
#######  #
#     O .##
# oo#  O  ##
# o@ #O O  ##
## o # O O  #
 ### #. O O #
 #   .  #  .#
 #   #  #####
 ########
