#########################
#   #   #   #   #   #   #
# o # # # # # # # # # o #
#  O O o o O O o o O O  #
### # # # # # # # # # ###
#  O O...... ......O O  #
# # # ###### ###### # # #
#  o .#     o     #. o  #
### #o oooo @ oooo o# ###
#  o .#     o     #. o  #
# # # ###### ###### # # #
#  O O...... ......O O  #
### # # # # # # # # # ###
#  O O o o O O o o O O  #
# o # # # # # # # # # o #
#   #   #   #   #   #   #
#########################
