  #####
  #   #####
### #     ##
#  O ####  #
#  O ##  # #
#  O  OO # #
#   #    # #
#@#OO O ## #
###  #o  # #
 # .o .O # #
 #   #  #  #
 ##  #    ##
  #########
