 #### ### ####
#    #   #    #
# #  #   #  # #
#  OOoOOOoOO  #
#  O .   . O  #
 ##o.## ##.o##
#  O #   # O  #
#  O   @   O  #
#  O #   # O  #
 ##o.## ##.o##
#  O .   . O  #
#  OOoOOOoOO  #
# #  #   #  # #
#    #   #    #
 #### ### ####
