  ####### ## #######
  #     ######     ##
  #.###  ##  .  ##  ##
  # .  #  oO# .#  #  #
  # #.  ###.#  Oo  # #######
  # o O    ###  .  #       ##
 ###o# O oo  ##o .########  #
##  o # O  #  # # .   #   # #
#  oo  o#. .# @ #. .#o  oo  #
# #   #   . # #  #  O # o  ##
#  ########. o##  oo O #o###
##       #  .  ###    O o #
 ####### #  oO  #.###  .# #
       #  #  #. #Oo  #  . #
       ##  ##  .  ##  ###.#
        ##     ######     #
         ####### ## #######
