 ###############
 #.  o  .  o  .#
 # ##o# # #o## #
 #  .O .#. O.  #
 # #   OoO   # #
##ooO   #   Ooo##
#  #. o. .o .#  #
#@   #O O O#    #
#  #. o. .o .#  #
##ooO   #   Ooo##
 # #   OoO   # #
 #  .O .#. O.  #
 # ##o# # #o## #
 #.  o  .  o  .#
 ###############
