 ###########
 #         ####
## #######    #####
# o#  #  ####     ##
#    oo .#  # ooo  #
#  #  # O#.o  o  # #
##  #  #.#.#  #o   #
#  o#.O....## o   ##
#  o  #....@# o ###
## ooo#.... # ###
###   #######  #
  ##         o #
   ##########  #
            ####
Title: Maelstrom Collection #4
