 #######  #### ####
 #  #  #  #  ###  #
 # oo  #### o o   #
 #  #o #  # o  o  #
 ## #@    #   ## ##
  # #o #o #   o  #
  # #  # ## o #  #
 ## #### ####o####
 #   o # #     #
 #  # .O ..o#  #
### # .  o. # ##
# .O ##   ##  O #
# ..O ##### o.. #
##...o     ..O. #
 #  .###### ## ##
 ######   #    #
          ######
Title: Maelstrom Collection #15
