    ####
   ##  ########
  ##   o  #   #
  #   o .  .  #
### # o O#o#o##
# o ####  ... #
# # #   #o##  #
# #.# O   #  ###
# .O # O O  #  #
##o .#o.o.#.@  #
#  #. .o. #oOO #
#  O.###  # . ##
# oo o #### . #
##   #    #Ooo#
 ##    ##     #
  #############
Title: Maelstrom Collection #17
