          ####
   ########  #
 ###  # o oo #
 # o oo   #  ####
 #    o ##  ##  #
 ###  #  #   oo #
   # #.. ##  #  #
 ### #.+.. #   ##
##.. o o #o. o  #
# .. #### . ### #
# OO .   .o. o  #
#  ##############
####
Title: Maelstrom Collection #20

