#### ######
#  ###    #
#  #   ...#
#  #  #...#
## ##o #  #
 # o   #  #
##@o## # ##
# oo      #
#  o ## o #
## #o####o###
#...O.  o o #
#  .  #     #
#############
Title: Maelstrom Collection #3
