    #########
    #   #   #
    #  . o. #
    ##o### ##
#####   #   #####
#  ##o.Oo..o##  #
#     . # .  o  #
# o#  o # o  #. #
## ##.#####.## ##
# .# o  #  o #o #
#  o  .o#o.   . #
#  ##o..@..o##  #
#####   #   #####
    ## ###o##
    #  o .  #
    #   #   #
    #########
Title: Maelstrom Collection #2
