###################
#      #          #
# o o    @o o o o #
###o#  o#.#o  #o###
  #  #  #.#  #  #
  ##  ###.###  ##
   ##  ##.##  ##
    ##.. . ..##
    ##..o.o..##
   ##  ##.##  ##
  ##  ###.###  ##
  #  #  #.#  #  #
###o#  o#.#o  #o###
# o o    ..   o o #
#      #   #      #
###################
Title: Maelstrom Collection #14
