  ####
  #  #####
 ##o #   #### #####
## o   o  o ###   #
# o   #O#   ## o  #
#   ###+###    # ##
## # ......# o o ##
 # # OOOOO.. # o  #
##  #O.O.O## o o  #
#  o#..O..#### #  #
#     ###  ###  ###
### o   oo      #
  #######  ######
        #### ####
Title: Maelstrom Collection #19
