        ####
  #######  #
  #       o#
  # O####. #
  # .   #.o#
####o#o.#. ####
#  o #  o     #
# ##.#  ####O #
# # .#### @   #
# #  o     #  #
#    ##    ####
############
Title: Maelstrom Collection #5
