###### # 
#   ## # 
#  . # 
#  o ### 
## O @ # 
###o # # 
  #.#  # 
# #   ## 
# ###### 
