#### ### 
#@ ### # 
# oo ### 
# o .  # 
## ..  # 
 ####### 
  
