  ##### 
 ##   # 
###   # 
#  O ## 
# .@o## 
#  O ## 
##  ## 
##### 
