  #### 
 ##  # 
 # . # 
 # O # 
## O### 
#  o # 
#  @ # 
#  ### 
#### 
