  ##### 
 ##   ## 
### #  # 
###o.# # 
#  o.#@# 
# #o.# # 
# #    # 
#  # ### 
##   ## 
 ##### 
