 #### 
 #  # 
 #  # 
 #  #### 
###oo  # 
#  o.  # 
# #..### 
# @# # 
##   # 
###### 
