##### 
#   #### 
# #o.  # 
#  .o#@# 
###o.  # 
  #  ### 
  #  # 
  #### 
