  ##### 
  ##  # 
###   # 
#  o  # 
# .O.## 
## o # 
###@ # 
  #### 
