##### 
#   ## 
#  o ## 
##oO. ## 
 # .@  # 
 #  #  # 
#####  # 
##  #### 
