  #### 
  #  # 
###  ### 
## oO  # 
#  O. @# 
#   #### 
#  ## 
##### 
