   ####
 ###  ##
 #     #
##O  # #
# OoO. #
#  @  ##
#######
