#####
#   #
#   ###
#ooo@ #
#...  #
#######
