 #####
##   ##
# .o. #
# o#o #
# .o. #
#    ##
## @##
 ####
