 #######
 #     ###
## ###o  #
#  .. o  #
#  .##o ##
### # @##
  #   ##
  #####
