    ####
  ###  #
  # oo #
 ## #  #
## .#o@#
#      #
# ..####
#####
