     #####
######   #
#   ## # #
# o@o    #
### ### ###
#         ##
#   ### .. #
#####    # #
    # #  # #
    #  ##  #
    ##    ##
     ######
