 #######
 #  #  #
 #  #o #
##  .O+#
#   #o #
#   #  #
##  ####
 #  #
 ####
