     ####
     #  #
 #####  #
 #  o o #
 # .#  ###
 # .#oo  ##
## .#     #
#  O###@  #
#        ##
## .######
 ####
