 ####
 #  ###
 #o   #
 # .# #
##O.  #
# o ###
# @ #
#####
