   #####
 ###   #
##     #
# OOo ##
#  O .#
### #@#
  #   #
  #####
