   ###  #####
#### ####   #
#  ###      #
# ..  oooo  #
# ..  # @#  #
#############
      #  #
