  #####
### . #
#  . o##
#  oo. ###
### .oo@ #
  ##o .  #
   # . ###
   #####
