######
#    #
# ## ##
# # O ##
# #@O  ##
# # O   #
# # O o #
# ## #.##
#    ###
######
