   ####
   #  #
   #o #
   #  #
####@###
#  o   #
#  ..O #
#   #  #
########
