#############
#       #   #
#    ## #   #
## ### o o ##
#@...# ooo #
#          #
##..########
 ####
