  #####
###   ####
#   o  o #
# o##  o #
##     # #
 ##### # ###
     # ... #
     ##.   #
      ## @##
       #  #
       ####
