 ########
 #  #   #
##  #o  #
# .O@O. #
#  o#  ##
#   #  #
########
