  #####
  #   #
  #   #
  #  ###
###. # #####
#  . ###   #
#  . # o   #
# #.## o o #
#  . @  oo##
##  ###   #
 #### #####
