 ######
 #    #
 #. ..##
###o @ #
# o  o #
#   ####
#####
