#######
#     #
# ooo.#
## #@.#
 # # .#
 #  # #
 ##   #
  #####
