#####    #####
#   ######   #
#          # #
## ####### # #
 # #     # # #
 # #oo ..... #
## #   #######
#  #o#@#
# o o  #
#  #  ##
####  #
   ####
