#########
#   #   #
# o...o #
# oO@Oo #
# o...o #
#   #   #
#########
