 #######
 #  #  ###
 #  #  . ###
 #   o # @ #
 ## # o o  #
  # ##..####
  #  #  #
### ### ###
#     o   #
#   ###.  #
##### #####
