###########
#         #
#  O . O  #
##OoO@OoO##
#  O . O  #
#    #    #
###########
