       ####
########  #
#     o   #
#  ##.##  #
##o##  . ##
 #  . o# ##
 # ###.#  #
 # ### @  #
 #   o ####
 #  ####
 ####
