    ####
 ####  ##
 #    o #
 # #  # #
## #ooo@#
# ..  ###
# .. ##
###  #
  ####
