 #####
##   #
#    #
# .o.##
##o#o #
 #.o. #
 #    #
 # @ ##
 #####
