########
#  #   #
#      #
#  ## ###
## ##   ####
 # ## ooo@ #
## ## #    #
# . . . ####
#   #####
#####
