    ####
 ####  #
 #     #
##.# # ##
#@o o#  #
# .o    #
##.o##  #
 #. #####
 ####
