 ######    ####
 # @  ######  #
 #  #   o     #
## ....# o #  #
#   ## ## o  ##
#      ### o #
######## ##  #
          ####
