######
#    #
# ##o###
# # o  #
# @.O. #
##     #
 #  ####
 ####
