######
#    #
# #o@#
# .O.#
# #o #
#    #
######
