   #######
  ## .   #
 ##  .   #
 # oO.# ##
 # # .  #
## # . ##
#  ### #
# #   @##
# ooo#  #
#     # #
###   # #
  #o##  #
  #    ##
  ######
