 #########
 #    #  #
 # o o   #
 ## ###  #
### # #@###
#   ###   #
# # . .   #
#   #######
#####
