#########
#  ##   ##
# o ooO@ #
#  # . # #
## #. .  #
 #   #####
 #####
