#####
#   ####
# # .  #
# #o.  #
# @oO# #
####   #
   #####
