########
#  ##  #
#  ..  #
# .  . #
### ####
 #    ##
 # oo@ #
 ### o #
###  # #
#    o #
#    ###
######
