   ####
 ###  ##
 # o o #
 #   # #
 ##o   #
  #  # #
  ## # #
  #. # #
  #.## #
###.## ##
#       #
#   @   #
#########
