#######
# . . #
#.ooo.#
# o@o #
#.ooo.#
# . . #
#######
