#####
#   ###
#     #
#     #
###.###
# oOo #
#  +  #
#######
