 ######
##    #
#  ## #
#@# o #
#  O..#
## #o###
 #     #
 ###   #
   #####
