#####
#   ###
# # o ###
# # o   #
# #.o##@#
# #.o   #
#  .#####
## .  #
 #    #
 ######
