 #####
 #   #
##.# #
#  @ #
#  o #
# #O##
#   #
#####
