   ####
####  #
#  #  #
# . . #
# @oo #
# # ###
#   #
#####
