 #### #####
##  ###   #
#  . #  o #
# . .o o ##
###O## # #
  #  # @ #
  #  #####
  #  #
  ####
