########
#      #
#    # #
###..o.#
  # #o##
  #  @ #
  ## o #
   # # #
   #   #
   #####
