     ##########
     #        ##
 ##### #### o  #
 #.. #     #   #
 #   .  # o  # #
 #.. #### # o  #
 ## ##  # oo#  #
  # #   ##    ##
###@###  ######
#     #
#     #
#  #  #
####  #
   ####
