     ####
     # @##
###### o ##
#  . # o  #
#      o# #
## ..#    #
 ##  ######
  ####
