######
#    #
# oo ###
### @  #
  #  . #
  ## .##
   ####
