########
#  o.  #
#  o.  #
###  ###
#  o.  #
#@ o.  #
########
