  #####
###   #
#  o# #
#  .o #
## ##.#
 #   @#
 ######
