  ####
 ##  ####
 #  oo  #
 # #  # #
 # o o# #
 # #  # #
 #@#  # #
## #o#  #
# .....##
#   ####
#####
