 #####
 #   #
## # ##
# o   ##
#  o#. #
## o . #
 #  #. #
 #### @#
    #  #
    ####
