  ######
  #    #
### ## #
# ...  #
#  o ###
# #o##
#  o #
#  @ #
######
