 ####
##  ###
# .o  #
#@.o  #
# .o ##
##  ##
 ####
