 #######    #####
 #     ######   #
##      @ ...   #
#  ########## ###
# o  o   o     #
#  #   #   #   #
################
