    ####
 ####  ###
 #     o #
 #  oo # #
 # # @#  #
## ####  ##
#  ...    #
# ### #   #
#     #####
#######
