 #####
 #   #
 #   ##
 #oOo #
##. . #
# .@.##
# oOo#
##   #
 #   #
 #####
