    ######
    #    ##
 #### ##  #
##      # #
# @oOO. # #
#   # ##  #
#####    ##
    ######
