 #####
 #   #
 #o#@#
## o #
#   ##
#.O. #
#    #
######
