  ####
  #  #
  #  #
  #  ###
###o o ##
#  o@o  #
#   #   #
###### ##
  ## . .#
  #  . .#
  #     #
  #  ####
  ####
