 #######
 #     ###
 # ###.  #
 # # . # #
## #...  #
#@   .####
#  #  #
## #####
# oo   ##
#  oo   #
### oo  #
  #     #
  ##   ##
   #####
