       ####
 #######  #
##   ##   #
#    #  o #
# # ##o  ##
# #   o ##
#@# .#o ##
#  ..  ##
###. ###
  #  #
  ####
