### #######
## ####   #
# ## ...# #
 ###o   # #
##  oo### #
## @      #
###########
