########
#  #   #
#      #
#  ## ##########
## ##  #       #
 # ##  #       #
 # ##  o o o o #
## ### #######@#
#    . . . .   #
#   ############
#####
