   ####
  ##  #
  #   #####
  #       #
  #   #   #
  ##    .##
   #####.#
  ######.###
  #     .  #
###  #o#.  #
#  oo o ####
#   o @ #
###  ####
  ####
