  ########
  #  #   #
  #  o   #
  #  ##o##
#### ##  #
# @...#o #
#        #
######  ##
     ####
