 ##### #####
 #   ###   #
 #@o  ##.. #
###o#      #
#   ## ##  #
#       ####
#   #   #
#########
