        ####
        #  #
      ###  #
     ##    #
     #  #o###
     # o o  #
     ##o    #
#######  ####
#     #  ##
#  @  ##  #
#  #  ....#
#    ######
######
