 #####
## @ ####
#  #  . ##
# #      #
# oo #.  #
##    ####
 ##   #
  #####
