########
#      #
# #.#  #
#  O   #
##oOo ##
#  O@##
# #.##
#   #
#####
