######
#.#  #
#@oo #
#..o #
##   #
 #####
