       ######
    ####    ###
    #    ##   #
 #### ###..## ####
 #  #oo     #    #
##  o o #... @ # #
#  #  o ##### #  #
#    ####  #    ##
##   #     #   ##
 #####     #####
