   #######
  ##     ##
###  ###  #
#   #   # #
#@oOOO. # #
##      # #
 #### ##  #
    #    ##
    ######
