  ##########
  #   #    #
### ... .# #
#    ## ## #
#    ##  # #
###  #@  # #
 ##  ##  # ###
  ##### o#o  #
   ## # o    #
    ### o##  #
     ##  #####
      ####
