     ####
     #  ###
    ## .  ##
    #. .   #
    #.  #@ #
    ## ##  #
   ##  #####
  ## o #
 ## o  #
## o  ##
# o  ##
#   ##
#####
