####
#  ####
#  #  #
#.oOO@#
##    #
 #   ##
 #####
