  ########
  #  #   #
###... . #
#    # ###
# @    #
###  # ##
  ### o #
  ## o  #
### o  ##
#  o  ####
#    #   #
#  ##    #
#       ##
##  #  ##
 ####  #
    ####
