 #####
 #   #
## . #
#  O #
# # ##
#  o #
## O #
 # @ #
 #####
