 ######
 #  . ###
## o.   #
#  oOoo #
#..O@O..#
# ooOo  #
#   .o ##
### .  #
  ######
