########
#   @  #
#   O  #
###.o###
  # O #
  #   #
  #####
