 ##########
 #  ##    ##
 #     ##  #
 # # o#  # #
 # #  @ o# #
 # #  #o   #
 # ###  ####
## .   ##
#  .####
#  .#
#####
