            ####
           ##  ###
          ##  @  #
         ##  Oo .#
        ##  OO  ##
       ##  OO  ##
      ##  OO  ##
     ##  OO  ##
    ##  OO  ##
   ##  OO  ##
  ##  OO  ##
 ##  OO  ##
##  OO  ##
#  OO  ##
# OO  ##
#  ####
####
