 ####
 #  ###
##    ##
#  O . #
# OoOo #
## .o. #
 #@  ###
 #####
