#########
#       #
# OoOoO #
# o...o #
# O. .O #
# o...o #
# OoOoO #
#      @#
#########
