   ####
   #  ###
   # .  #
   #o.@ #
#### .o #
#  oo.###
#     #
#######
