    ####
  ###  #
 ## .  #
##     #
# .o. ##
# o ###
# .o####
###    #
 ##o#  #
 #  #  #
 #  @ ##
 ###  #
   ####
