#####
#   #####
#   o o ###
## o    o ##
 ###### .. #
     #. . @#
     #     #
     ###  ##
       ####
