  ####
###  #
#  . ##
# #O  #
# o.#@#
##o.# #
#  o  #
#   ###
#  ##
####
