 #######
 #     ##
 # ###  ####
 #   ##    #
 #  o #### #
####o .....#
#  #  #### #
####oo#    #
 #  o # ####
 #  @ # #
 # #### #
 #      #
 ########
