#######
#  +  #
# OoO #
#. # .#
#  #  #
#  #  #
#  #  #
# o#o #
#  #  #
#######
