  #####
 ##   #
 #  # #
##    #
#  o ####
#  oo#. #
###o    #
  #  #  #
  ####. #
   #@#. ##
   #  .  #
   #     #
   #######
