########
#      #
# ###o #
# #  o #
# #.Oo@#
# #.#  #
#  .#  #
########
