 ######
 #. . #
 #  O.##
###o @ #
# o  o #
#   ####
#####
