  #######
  #     #
### ### #
# ..O   #
#  oo@ ##
####  ##
   #  #
   ####
