     #####
 #####   #
##  +  # #
# oo.oo  #
#  #.# ###
##  .  #
 #######
