######
#    ###
# o @  #
#  ### #
# oo o #
#     ###
### ##  #
# ....  #
#       #
#  ######
####
