         #####
         #   #
########## # #
#.     #  o  #
#.  @  #    ##
#.# #######  #
#         oo #
##  #####    #
 ####   ######
