 ##########
 #        #
 #.####   #
##.o @ oo #
# .O.o #  #
# ### ## ##
#        #
##########
