   ####
####  #
#@.O  #
#  #  ###
####  o #
   #  # #
   ##   #
    #####
