#####
#   #
#   ######
#oooo o @#
#.....   #
##########
