 #####
 #   ##
 #o#@ #
 # o  #
##  ###
# o.  #
#. .  #
#######
