#####
#   ####
#  .#  #
## ..  ##
 # ## @ #
 # #    #
 # o ####
 # o##
 # o #
 #   #
 #####
