 ######
 #    ###
 # o  o #
 ##o# # #
### #@# ##
# . . .  #
#   ##   #
##########
