  #####################
 ##        #     #    #
 #  o o o  #o o o o  o###
 # o##### oo  o## ## o  #
 #  #  ..#   # #    #   #
 ##o   ... # #   ...#o ##
##   o ... #o #  ...o  ##
#  o####..#    ##...##o #
#    O.O..oo@oo..O.O    #
# o##...##    #..####o  #
##  o...  # o# ... o   ##
## o#...   # # ...   o##
#   #    # #   #..  #  #
#  o ## ##o  oo #####o #
###o  o o o o#  o o o  #
  #    #     #        ##
  #####################
