       #####
     ###   #
#### #  oo ####
#  ###  o  #  #
#    ###oo  o #
# O#  @  ## # #
## ##### #..# ##
 #    ## #..#  #
 ##  o # #..   #
# ## o #  ..####
 # ##    #  #
  # ####   ##
   #   #####
