                #####
          #######   # #####
     ######       #.###   #
    ##      # ### #.    O #
    #  ###### ##  #  ### ##
    # ## o ..o # o   ##  #
    # #  o O.o@##### #  ##
    # #    ..o # o   # ##
#####o#######o## # .   #
# o            . #### ####
# oo# #########o##   .   #
# # . .#      .  # ooOoo #
#   .  # o.o.#   #... ...#
##### o # ## ##### ooOoo #
    #.#    #         .   #
    ######################
