     #######
     #  @  #
###### ### ######
#   #   o   #   #
#   o   #   o   #
##o###O###O###o##
#   o   #   o   #
#   #   O   #   #
##o###O###O###o##
#   #   o   #   #
# ..O...#...O.. #
###### ### ######
     #     #
     #######
