    #####
    #   #####
    # # #   #
    #     # #
 #####.# ...#####
 #  .oo ###o#   #
 # #.#     o. # #
 #  .# ooo  #   #
###  # o@o #  ###
#   #  ooo #.  #
# # .o     #.# #
#   #o### oo.  #
#####... #.#####
    # #     #
    #   # # #
    #####   #
        #####
