  ######
  ##   ###########
  # o o  o  # O  ######
  # .O.#..O.# .o     ##
  # O  # o o  O o#O.o #
 ## ####    # .  # O  #
 #  o #########.## .o #
 #.O.. O        #### ##
 #o o #o#.oo.O# #    #
 #    # #O.oo.#o# o o#
## ####        O ..O.#
# o. ##.######### o  #
#  O #  . #    #### ##
# o.O#o O  o o # .o #
##     o. #.O..# O @#
######  O #  o  O.o #
     ###########   ##
               ######
