   #############
   #     #     #
   # o o o o o #
   ### ##### ###
####.o   o   o.####
# ...# o # o #... #
#  o##O#.#.#O##o  #
##   . . @ . .   ##
#  o##O#.#.#O##o  #
# ...# o # o #... #
####.o   o   o.####
   ### ##### ###
   # o o o o o #
   #     #     #
   #############
