 ###########
##    #    ##
# ooO.o.Ooo #
#...     ...#
# ooO.o.Ooo #
##    O    ##
# ooO.o.Ooo #
#...  @  ...#
# ooO.o.Ooo #
##    #    ##
 ###########
