 ##########
 #    #   #
 # o  #   #     ####  #####
 ### oo   #######  ####   #
## o  o  ###   ##  o      #
# o   ###  # # ##  ##### ###
#  #o#       ..### ##  #   #
#    #  #.# #.. #   # o  o #
### o o #.# #.. #   #  ## ##
  #  #  #.#  #### #### ##  #
 ########.#         # o  o #
 #  ..  #.# ######  #   #  #
 #.oooo.#.# #   #  #### ####
 #.o @o.#.# # # #  o      #
 #.oooo.#.# #   #  ####   #
 #  ..   .  #   ####  #####
 ############
