    ####
    #  ######
    #  o o  ###    ####
    #   o     #   ##  #
#####O#O#ooo  #  ## o #
#     o o   o # ##    #
#  #o    o o##### oo ##
## # ####  .....#   ##
#      # o  OO.## ###
#   #  # oo #.##.   #
##     #    #.#+O # #
 #     ######.##..o #
 ####### # o..##.####
         # # O..O.#
         #   .#.  #
         ######o# #
              #   #
              #####
