         #### ####
         #  ###  #
      #### o o   #######
      #   o   #o   ##  ####
      # ### ###        #  #
     ##  o   ###### #     #
     #  o # ##    #####   #
     # # #  #  # oo # ## ###
     # #    #o.## o        #
     # ######   o  # ###   ##
     #....O.OO.# #   # #   ##
     ####      # ##### #####
       ##o## ###o#
      ##  #   o  #
#######   # o    #############
# o      ###### ##         @ #
#        .........           #
##############################
