    #######
    #     ###
    # ###o  ##
    #....o   #
  ### ## #   #
###@.o  # # ##
# .O.o   ## #
#  o.o  #.oo#
#  ## ##    #
#####   # ###
    ###  o #
      ##   #
       #####
