  #####
  #   #####
  # oo#   #####
  #   . o #   #####
 ### ##   . o #   #####
 #   ##.### ....o #   #####
 # oo#   ###.##.  # o #   #
 #   # o #  .##.###   .oo #
### ##   .ooo#   ###.##   #
#   ##.###   #ooo.   ## ###
# oo.   ###.##.  # o #   #
#   # o #  .##.###   #oo #
#####   # o.... ###.##   #
    #####   # o .   ## ###
        #####   # o .   #
            #####   #oo #
                #####  @#
                    #####
