   ##########
  ##        #
 ##    ###  #######
 # oo #    o#  #  #
 #  ###  #oo      #
 #    oo #     #oo#
 #  #   #### #o   #
 ## # ###.O. # ## #
## O.O.#..O.##    ###
#  OOO...OO.### oo  #
# #....#...#  #   # #
#  ## ##.O. o # ### #
##  # o ..##   o  # #
 ## # oo### o#oo  # #
  #  @  #   o    #  #
  #####   ##o####  ##
      ######      ##
           ########
