      #####
      # . #
  ##### . #####
  #   o . o   #
  # o ##.## o #
  #   # o #   #
###o##     ##o###
#   #  OOO  #   #
#....o O@O o....#
#   #  OOO  #   #
###o##     ##o###
  #   # o #   #
  # o ##.## o #
  #   o . o   #
  ##### . #####
      # . #
      #####
