         #######
  ########  #. #
  #        o O #####
  # ## ##   #. #   #      ####
### # o oo#o#. # # ########  #
#  o#   #  o O #......       #
# o    ### o#.  #  ####      #
## # #oo # o .# #  #  ##     #
 # #   o   @##  # ##   ##   ##
 #  ##  ooo #  ## ###   #####
 ##  #.##.###       #
  ## #Oo.O...  ##   #
   #   #   ##  ##  ##
   ###   ###########
     #####
