             ####
   ##### #####  ##
  ##   ###       ##
 ##   O O . o # @ ##
 #  ## O ## ### #  #
 # ## O  #  # o  # #
 # # O  #  #     # #
## #   ## # # ###  #
#  ## # #. o .##  ##
# #.# ## ## #.#  ##
# #  o  #. o .o ##
#   #O  o.#  . ##
##### ## ## # ##
    # # o  #  #
    # #    # ##
    #  #o##  #
    ##      ##
     ########
