   #####
####   #
#    o #
#   #o###
## ## @ #
# ..#   #
# ..oo ##
##  #  #
 #######
Title: Big uborka
