 ####      
 #  #####  
##O O   ## 
# o #  O ##
#   ##O  .#
### #  O# #
 #      # #
 #  # ### ##
 #   O@##  #
 ###  O O  #
   ##   #  #
    ########
Title: Only you
