   #####
  ##   #########
  #       ##   ##
 ## #o#...o o#  #
##     #O#.#. o #
#  #ooo#+#OOO#  #
# o  # #O#. .  ##
#  #o o...#o# ##
##   ##       #
 #########   ##
         #####
Title: Father diode
