     #####
######   ##
#    o o  #
# # ###o#@#
#   #  o  ##
##.... #oo #
 # #.### # #
 #  .      #
 ##   ######
  #####
Title: Return
