######
#    ####
# # o   #
#  O#O  #
##o.@.o##
#  O.O  #
# # # # #
#   #   #
#########
Title: Red star
