##########
#   ##   #
# o @  o #
## #### ##
#  ..## #
# o.O. o#
#  #.## #
###  #  #
 #     o#
 #   #  #
 #  #####
 ####
Title: SokoSutra
