   #######
 ###  .  ###
## O #o#oO ##
#  O  O  .  #
# #o#@Oo# # #
#  .  #  .  #
##   ###   ##
 ##### #####
Title: Semechki
