  ####
###  ####
#  o  o #
#  #.#o #
# ..O..@#
## #.#o##
#  o  o #
#   #   #
#########
Title: Burlak
