 #####
 #  @##
 # oo #
 #o # #
## ...#
#  # ##
#    #
###  #
  ####
Title: Cherta
