#####
#   #######
# o    #  #
##o#   oo #
#  ##.##  #
# oo...  ##
#  #...#@#
# #### #o#
#        #
##########
Title: Tamagochi
