###########
#  #   #  #
#@   o    #
#  ##O##  #
## ##.## ##
#   #... ##
# #o##.#  #
#  o   oo #
#####  #  #
    #######
Title: Contra
