   #####
  ##   ####
 ## o.o   #
 #  #.#   #
## . @ #o##
#  #.# .o #
#   . #   #
### o o ###
  ####  #
     ####
Title: Karusel
