  #########
  #   #  @#
 ##  .o.# #
 #  ##  o #
##  .oO#o##
#  #o#   #
#  . .# ##
####    #
   ######
Title: Track
