  #######  
  #  #  #  
  #     #  
  #..#oo#  
###     ###
# ...#ooo #
#         #
###..#oo###
  #  @  #  
  #######  
Title: Flip-Flop
