       ####
   #####  #
   #   #  #
   #  o o #
 ### #o   ####
 # o o ##o   #
 #  # o@o # o#
 #  #  o   o #
 ## ####O##  ####
 # o#.....#     #
 #  O...O..o# o #
## o#.....#   ###
#   ###.#.#####
# oo  #  ##
#  #     #
######   #
     #####
Title: Original
