 #######
 #  +  #
##o#O#o##
#   .   #
# o . o #
## #O# ##
 #  .  #
 #######
Title: Korona
