   #######
 ###  #  #
 #  o@   #
 # #  #..#
 # oo##..#
####  .OO#
#   oo.# ##
#   # ##  #
####   o  #
   #   #  #
   ########
Title: Uspex
