    ######
   ## ...#
  ## o # #
  # o ...#
###o  # ##
# o@#   #
#  o #  #
#   o  ##
##  #  #
 #######
Title: Bumerang
