       ####
##### ##  #
#   ###   #
#  o@o    #
## o#o#  ##
 # ...# ###
 # #OO#oo #
 # ...  # #
 ##   #   #
  #########
Title: Svadba
