  #######
###  #  ###
#  o.@.o  #
# # ... # #
# o #.# o #
##  #.#  ##
 # o o o #
 #  ###  #
 #### ####
Title: Sharlotka
