#####
#   ######
# #o##   #
#    o   #
###o ##o##
  # ... #
  #o .#o#
 ## ... #
 # o#.#o#
 #   @  #
 #  #  ##
 #######
Title: Kuterma
