   #####
####   ###
# @OO .. #
# o    # #
# o #### #
###      #
  ########
Title: Ustal
