 #####
 #   ####
 # .@.  #
###.o#  #
# o.o.o##
#  .#. ##
##o o o #
 #  #   # 
 ########
Title: Raketa
