  ####
###  ########
#  o  .+.#  #
#  o #o#O.  #
###o##...#  #
 ## # ooo  ##
 #  # # ## #
 #         #
 #  ########
 ####
Title: Flying idea
