 #####
 #   ### 
 #  o  # 
###.o. # 
#  o.o###
# #.o.  #
# #o@o# #
#  .o.# #
###o.o  #
 # .o.###
 #  .  # 
 ###   # 
   ##### 
Title: LM
