 ########
 #   #@ #
 # O.o o##
###O.# o #
# o o.O  #
#   #..###
##      #
 ####   #
    #####
Title: Kubiki
