########  
#   #  ##
#   o   #
## ##..o#
 #@## . #
 # . ##o#
 #o .## ##
 #   o   #
 ##  #   #
  ########
Title: Kompas
