####      ####
#  ########  #
# o # .. # o #
#  ooo..ooo  #
##    OO     #
 #@ #....#  ##
 ############
Title: SokoBat
