 ########
 #  #   ###
##  o     #
#   ##o#  #
# o #..# ##
###o#..# #
  #@o..  #
  #o# #  #
  #   ####
  #####
Title: Wake up
