    ####
   ##  ###
####     #
#  #O.O# #
#   .#.# #
#  #O.O  #
##   # o##
 #  o@# ##
 ## #o#  #
 #    o  #
 #   ##  #
 #########
Title: Dreams
