#######
#...  ###
# ##    #
#  o  o #
#.#o##o##
#   #@ #
###   ## 
  #####
Title: Lastochki
