  #######
  #  #  ###
### o# .  #
#  o.o.   #
#  .o.o.###
## o.o.o#
 # .o.o@#
 ###.o### 
   #  #   
   ####   
Title: Marazm
