#####
#   #########
# o    ##   #
##o#...     #
## ##o#### ##
#  ##..+ #  #
#  o   # o  #
#  ###o###  #
#####      ##
    #   ####
    #####
Title: Double choice
