##### ####
#   ###  ##
#    o    #
##o##@# #o#
 # #....  #
##  ....# #
# o# # ##o##
#  o o o   #
#  #####   #
####   #####
Title: Luja
