    ####
#####  #
#   #o #
#      ##
##o###  #
 #  ... #
##o# .###
#  ##@##
#  o   #
#  #   #
########
Title: Telefon
