    #####
#####   #
#   #o# #
# o  o  #
##o#@## #
#     # #
# o##o# ##
#  # .#  #
## ...   #
 ###..#  #
   #######
Title: Irka
