  ####
  #  ###     
  # o  ######
  #  #o##   #
  ##. . . o #
 ### #O# # ##
 # o.O@O.o # 
## # #.# ### 
# o .   .##  
#   ##o#  #  
######  o #  
     ###  #  
       ####  
Title: Krenol
