   #####
  ##   #########
  #       ##   ##
 ## #o#...o o#  #
##    .#o#.#. o #
#  #ooO#+#OoO#  #
# o  #.#o#. .  ##
#  #o o...#o# ##
##   ##       #
 #########   ##
         #####
Title: Ziko-City
