###################
#  .   . #        #
#.#o##o# # #o##o# #
#o  ## o  o .##. .#
#.#o  .# # #  o # #
#   ##   #  .##. .#
# #o##o##### ## # #
#     .  #@o  . o #
#     .  # o  . o #
# #o##o##### ## # #
#   ##   #  .##. .#
#.#o  .# # #  o # #
#o  ## o  o .##.#.#
#.#o##o# # #o##o# #
#  .   . #        #
###################
Title: Bardak
