#####     
#   ##    
#  o #    
## o.#####
 # o.@#  #
 ##oOo   #
  # ...  #
  #  #  ##
  ####### 
Title: LoLa
