########
#   #  #
#      ##
## ##   #
 # O..#o#
 # O..  ##
 ##o###  #
 #    oo@#
 #   ##  #
 #########
Title: Aniska
