    #####
#####   #####
#   # #o#   #
# #  ...  # #
# o #.#O# o #
###o###.. ###
 #    o    #
 # #@###o# #
 #   # #   #
 ##### #####
Title: Sheriff
