  ####
  #  #      
###  #      
#    #####  
#  O #   ###
### O#  Oo #
 ## O  OO@ #
 #  #   O.##
 #  ####  # 
 #  #  #### 
 ####       
Title: Pereprig
