####   #####
#  #####   # 
#  o @  o  # 
#  # ...# ## 
##o##.#.# ## 
#   o.#O#  ##
#   #   oo  #
#########   #
        ##  #
         ####
Title: Depth
