  #######
###  +  ###
#   #o#   #
# #  O  # #
#  # O #  #
##   #   ##
 #########
Title: Vverh
