      #####
#### ##   ###
#  ###  #o@ #
#...     oo #
#. .## # #  #
#...#  oo#o##
##  oo#     #
 ###    #   #
   ###  #####
     ####
Title: Okno
