 ####
##@ #####
# ooo   #
# # # # #
# ...   #
####   ##
   #####
Title: Miner
