   #####
####   #
#  #.#o###
#   . o  #
#....#o# #
###o# o  #
 # o  @ ##
 #   ####
 #####
Title: Ugolok
