       #####
########   #
#  #       #
#    o ## ##
#  ###### #
##o####.. ###
#  # ..oOo  #
#    O@ . # #
#  #oO #### #
#### ###### #
   #        #
   ##########
Title: Krik
