#####
#   #######
#    o    #
## ##...  #
##o##o##o##
#  ...## ##
#   o@o   #
#######   #
      #####
Title: Suriken
