    ####
 ####@ #
 # o   #
## ###o##
#.  o  .#
#   #   #
### # ###
 #.   #
 #   ##
 #####
Title: Mini zagadka
