   #######   
 ###  .  ####
## o #.# o  #
# o o#.#o o #
#  o.. ..o  #
### ##@## ###
  #   .   #  
  #########  
Title: Chmoki
