  #######
  #  #  ###
###.o.o. @#
#  . #o.o #
# #o .o. ##
#  . oo ##
###  #  #
  #######
Title: Zavhoz
