   ####
 ###  #
##    ###
# o o   #
# #o# #o##
# . .o.  #
##.@. #o #
 ###.   ##
   #  ###
   ####
Title: Magazine
