      ####
#######  #
#  o     #
#  o#    ####
###  # ###  #
  # o@o  oo #
  # o## ##  #
  #   .... ##
  ####...  #
     #######
Title: Xolodok
