      ####
#######@ #
#  #.O.o #
#   .#.o #
#  #.O.o##
##   o#  ##
 # ##     #
##o   #   #
# o  ###  #
#   ## ####
#####
Title: Blue Eye
