   ####
   #  #
####. ####
#   .    ###
# .o.ooO.O #
###  o@o   #
  ####o.####
     #  #
     ####
Title: My heart
