    #####
   ##   ###
  ##      #
 ## o#oo# ##
## o  o  o #
#  # #o# # #
#  ...@....#
#  #########
####
Title: Katenka
