####   #####
#  ## ##   #
#   ### o  #
# oo    o ##
##  ####o##
 ##   . o #
  # # ... #
 ##o##OO###
 # o ...#
 #   ##+#
 ########
Title: Pryanik
