   #####
####   #
# o  #.##
#   O   #
##.#  o #
 # @ ####
 #####
Title: Zerkalo
