 #######
 # .   # 
##o#O# ##
#  O    #
#   @O  #
## #O#o##
 #   . # 
 ####### 
Title: Osen
