  ####
  #  ####
 ##  o  ###
 #  ##o.. #
 # o@# .  #
## #ooo# ##
#  . #   #
# .. ##  #
###     ##
  ####  #
     ####
Title: Anchor
