    ####
#####@ #
# o ooo##
#  .#.  #
## #  # #
 # . .  #
 #   ####
 #####
Title: Kubizm
