 #########
 #   #@  #
 #   OO#o##
### #     #
# ooOO#.# #
# # #  .  #
#   ##.  ##
##    .#o#
 #  ##   #
 #########
Title: Kruchok
