  #####
###   #
# oo# ####
# o@O.   #
# #o...#o##
#   .. o  #
###  ##   #
  #########
Title: GKI
