   #####
  ##   ###
 ##  #   #
 #   oo# #
 #o.#    #
##..Oo# ##
# .#O   #
#  . #o@#
####   ##
   #####
Title: Metro
