   ########
####  #   #
#  #      #
# o   ##o##
#  ## ## ###
## .OO##   #
 #  O+O  # #
 ## ####   #
  #      ###
  ########
Title: Zagar
