     #####
  ####   ##
 ##  oo o #
 #    .#  #
 #  .#    #
##.#o oO ##
#    . ###
# @.####
#####
Title: Dva brata
