#########
#  ##   #
#  o    ###
#  ##o #  #
## #   oo@#
 # O. ##  #
 # #.###o##
 #o#O##   #
 # ..#    #
 ##..    ##
  #  #####
  ####
Title: KUB
