 ########
 #  #   #  
##o oo# ###
#.O.#@o   #
#...#o#   #
#.#Oo  # ##
# #    # ##
#  ##     #
##    #   #
 ##########
Title: Monster
