####  #####
#  ####   #
#   o     #
#  #o###o##
## .O.O..# 
## ## # ## 
#     o  # 
#   ##@  # 
########## 
Title: Mekom
