#####  ####
#   ####  #
#      o @#
##o#####  #
#  #...o ##
#  o. .#  #
#  #...##o##
##o###o##  #
#       o  #
#   ##  #  #
############
Title: The doors
