########
#  #   ###
#   .o.  #
#  ##@## #
## o.o.  #
#  #   # #
#  oO#.o #
####   ###
   #####
Title: Rostok
