#####  ####
#   ####  #
#      oo #
##o#####  #
#  #.. o ##
#  ...##  #
#  #.. #o@#
####   #  #
  ##o#### ##
  #    o   #
  #   ##   #
  ##########
Title: Honour
