  #####
 ##   #
 #    #####
##o# ##   #
#@ # o    #
# o.O.O ###
#  o.O. #
##  # O #
 #####  #
     ####
Title: for Paul
