#####
#   #####
# # ##  #
# o    o##
### ..#  #
  #o...  #
### @..# #
# o  o o #
# # ###o #
#   # #  #
##### ####
Title: Verenica
