    #######
   ##     #
  ## o##  #
 ## .. .  #
 # oo##o  #
##o.O@O.o##
#   ##o  #
#  . ..###
#  ##o #
#     ##
#######
Title: Tiskoteka
