    #####
 ####   ###
##  o o   ##
#  ### ##  #
# #  o   # #
# ...O.... #
# # o o  # #
#  ## ###  #
## o   o  ##
 ### @ ####
   #####
Title: The X
