 #####
 #   ######
 #  o #   #
 #..O.o   #
## #oO@#o##
#   o.o# # 
#   #..  # 
#####  ### 
    ####   
Title: Povorot
