####
#@ ########
#  O  #   #
#.OOo     #
#   ### O.#
#   #  oOo#
#####   . #
    ####  #
       ####
Title: Minutka
