 ####
 #  ###
##    #
#  o  #
# ooo###
## o   ###
 # ##o   #
##  #    #
#   ### ####
# # #....  #
#    .# .# ###
### #@ ..    #
  #  ....# # #
  #### ###   #
    #    #  ##
    #   o## #
    ###   o ##
      ###ooo #
       #  o  #
       #    ##
       ###  #
         ####
Title: Rebus
