####
#  ### #####
#  o ###   #
#  o o@o   #
##o# ...#o##
## ##.#.  ##
#     # #  #
#   #.O.o  #
#########  #
        ####
Title: Mad Dog
