   ####
 ###  ###
 #   oo ##
 # #     #
 # #  #O #
 # # o#. #
## #o@#O.#
#    o#..#
#   # .O #
#######  #
      ####
Title: Krasotka
