  ########
 ## @    #
## ...## #
#  O.O   #
# #OOOo ##
# o o ###
##  #  #
 #  o  #
 ####  #
    ####
Title: CFL
