  ####
  #  ###
### oo #
#    # #
# #....#
#  oo  #
##..#OO#
 #oo  @#
 #   ###
 #####  
Title: Egoza
