 #####
 #   #####
 # o o o #
 ###.... #
####O.O ##
#   o o##
#   #@  #
#####   #
    ##  #
     ####
Title: Mapat
