########
#  #@  #
#  o   ####
# o#.##   #
##  ... # #
 # ##.. o #
##o##.#o# #
#  o  o   #
#   #######
#####
Title: Oberon
