  ###### 
### @. # 
# . o# ##
# o . o #
## # o. #
 # .o ###
 ##  ##  
  ####   
Title: Strelka
