######
#   .#####
# # .    #
# # .#o# #
#.  .# o #
## #.@ # #
 # o # o #
 ###  oo #
   ##   ##
    ######
Title: One left
