 #########
 #   ##  #
 #       #
 ##o# #oo##
 #...O....#
## #o#o#  #
#  o   o ##
#   #@  ##
#########
Title: Nitka
