  ##########
  #   ##   #
###   . .# #
#  # ##  o #
# o  .OO#o##
#   # #   # 
##  Oo.# ## 
 ####   @#  
    ######  
Title: Triple Shelf
