    ########
 ####   #  #
 #  #.#.   #
 #   OOO#  #
 #  #...  ##
### ##o## ##
#  o# o    ##
#  o @##    #
## o#####   #
 #  #   #####
 ####
Title: Sambist
