####
#  #######
#   o@#  #
#  #OO.  #
##o# .#  #
#  # O# ##
#    O  ##
#  # ##  #
###      #
  #   ####
  #####
Title: Trevoga
