##########
#   ##   #
#   o    #
##.#O## ##
# ..O @ ##
# OOO #  #
###.# #  #
 #  #oo  #
 #  o  ###
 #  #  #
 #######
Title: Serpik
