##### #####
#   ###   #
#  o   o  #
## #...# ##
 # oOOOo ##
 ## ...#  #
  #@ #oo  #
  ##   ####
   #####
Title: Rogalik
