 ####
 #  #
##  #######
#  .o #   #
# .oO # o #
##oO . . ##
 #  # OoO #
 # @## .  #
 ####   ###
    #   #
    #####
Title: Domovoy
