#####
#   ######### 
# o         ##
##o### # o...#
 # o   ## o .#
## # ..#  o#.#
#..##.##  o  #
#.  o  ## o###
#  # oo@#  #  
#####   ####  
    #####     
Title: Juravli
