########## 
#   #    # 
# #ooooo # 
#  .#.#  # 
#  ...  ## 
### @ ### 
  ##### 
