########## 
# ##  #  # 
# # O #### 
###o .o ## 
#  . @ O # 
# O   .  # 
## o. o### 
#### O # # 
#  #  ## # 
########## 
