##### ##### 
########### 
##   .   ## 
## .o.o. ## 
## oOoOo ## 
 #..o@o..# 
## oOoOo ## 
## .o.o. ## 
##   .   ## 
########### 
##### ##### 
