       #### 
  ######  # 
  #    #o.# 
 ## ## #  # 
 # o oooo # 
##.O.O.O..# 
#     @   # 
#   ####### 
##### 
