   ######## 
  ##  #   # 
  #   # # # 
  #       # 
  #   ## ## 
  ##    .# 
   #####.# 
    #  #.# 
 ####  # ### 
##         # 
#  ##o##.  # 
#  o o ##### 
#  o @ # 
##  #### 
 #### 
