 ##### 
##   ## #### 
#  #  # #  # 
# OoO ###o ## 
# .o. ... o ## 
# OoO ###    ## 
#  #  # #    @# 
##   ## ####### 
 ##### 
