####  ####  #  ####  #### 
#  ####  #######  ####  # 
# .o. # .o. # .o. # .o. # 
#. o . . o . . o . . o .# 
#oo#ooOoo#oo@oo#ooOoo#oo# 
#. o . . o . . o . . o .# 
# .o. # .o. # .o. # .o. # 
#  ####  #######  ####  # 
####  ####  #  ####  #### 
