  ######## 
  #      # 
### ## # #### 
#  O.OO .O  # 
#  o   o# @ # 
#######   ### 
      ##### 
