  ####### 
###  #  # 
#  .oo. ## 
#  O  O@ # 
## .oo.  # 
 #  #  ### 
 ####### 
