       #### 
       #  ## 
      ## o#### 
     ###. .  # 
  #### o # o # 
  #  #  . .#### 
 ## o####o #  ## 
###. . o. o# o#### 
# o # o OO.#. .  # 
#  . .#.OO o # o # 
####o #o .o . .### 
  ##  # o####o ## 
   ####. .  #  # 
    # o # o #### 
    #  . .### 
    ####o ## 
      ## @# 
       #### 
