 ######## 
##      ## 
#  O..O  # 
# #o  o#@# 
#  OOOO  # 
##     ### 
 ###  ## 
   #### 
