        #### 
     ####  # 
     #     # 
  #### OO  # 
 ##  #  #  # 
 #  OOO #### 
##o ..... # 
# o # o o # 
#   ####o ## 
##### # @  # 
      #    # 
      ###### 
