########## 
#   ##   # 
# o.  .o # 
# .OOoO. # 
## o @O ## 
## O  o ## 
# .OoOO. # 
# o.  .o # 
#   ##   # 
########## 
