  ####### 
 ## ##  ## 
#####  o### 
# o ..  # # 
#   OoO.### 
## .o@o. ## 
###.OoO   # 
# #  .. o # 
###o  ##### 
 ##  ## ## 
  ####### 
