########## 
###     ## 
# o.O.Oo## 
# O#o #. # 
# .  @oO # 
# Oo   . # 
# .# o#O # 
##oO.O.o # 
##     ### 
########## 
