       #### 
      ##  ## 
      # o  ## 
  #####  O  # 
 ##  .  O O # 
##  O O oO .# 
#  O Oo..oO ### 
# o Oo.##.    ## 
##    .##.oO o # 
 ### Oo..oO O  # 
   #. Oo O O  ## 
   # O O@ .  ## 
   #  O  ##### 
   ##  o # 
    ##  ## 
     #### 
