      #### 
  #####  #### 
 ##   #  o  # 
 # .# # #O  # 
## O  @  O ## 
#  O# # #. # 
#  o  #   ## 
####  ##### 
   #### 
