######## 
##  #### 
##. #  # 
#  Ooo ###### 
#  o.      ## 
#####O###. ## 
  #   O O   # 
  # #.o@o.# # 
  #   O O   # 
  ## .###O##### 
  ##      .o  # 
  ###### ooO  # 
       #  # .## 
       ####  ## 
       ######## 
