        ######
####### #    ##
#     ### ##  ##
# #  o.##o  #  ##
#  #  O.@.O  #  #
##  #  o##.o  # #
 ##  ## ###     #
  ##    # #######
   ######
