        ####
        #  #
        #  #
        #  #
########## #
#    o o oo#
# @  o..O. #
#   # O...o#
#####o...O #####
    # .O..o#   #
    #oo o o    #
    # ##########
    #  #
    #  #
    #  #
    ####
