  ####
  #  #
  #o #
  #  # ####
### ####  #
#  .. ..  ###
# oO. O.o@  #
## #o o#o # #
 # #   #  # #
 #  ######  #
 ##        ##
  ##########
