     #####
     #   #
    ## # #####
   ## O  #   #
  ### # ## # #####
###   oo# O  #   #
#  O#.  o # ## # #
# #  O... oo# O  #
#   #oo ....o # #####
##### # o.+.. oo#   #
   #  O #oo ...O  # #
   # # ## # o  .#O  #
   #   #  O #oo   ###
   ##### # ## # ###
       #   #  O ##
       ##### # ##
           #   #
           #####
