    ##########
 #####   @ O#####
 ##  oo ##. .  ##
 # #    ##    # #
##  # ##  ## #  ##
##.     ##     o##
#O  # #O##O# # o #
# . # O    O #   #
# ## ## O  ## ## #
# ## ##  O ## ## #
#   # O    O # . #
# o # #O##O# #  O#
##o     ##     .##
##  # ##  ## #  ##
 # #    ##    # #
 ##  . .## oo  ##
 #####O     #####
    ##########
