     #####
     #   ###
  ####     ##
###   #.##  ##
#  o o o oo@ #
#  # ##.##   #
## # # . #####
#  # ...O.   #
# o###   #   #
# o   ###  ###
#   #     ##
###########
