        #####
        #   #####
   ###### #     ##
   #  ## O ####  ##
 ###       o   #  ###
 #   #####o#  o #   #
 # o  o  #  oo# #   #
 ###.#..O......... ##
###    o#  # o o # #
# o o## #### ####  #
# #  ##   @  #    ##
#  ##  ######  ####
##            ##
 ##############
