#######
#     ####
# # # .  ##
# oooOOoo #
#....@....#
# ooOOooo #
##  . # # #
 ####     #
    #######
