   #####
  #    ##  ######
 #  ##  # ##     #
 # #  # # #  ###  #
 # #  # ### #   # #
 # #  o  #  o   # #
 #  #o#O.#.O#o##  #
 ##   O.o o.O    ##
  ### .o . o. ####
    ### .#. ###
 #### .o . o. ###
##    O.o@o.O   ##
#  ##o#O.#.O#o#  #
# #   o  #  o  # #
# #   # ### #  # #
#  ###  # # #  # #
 #     ## #  ##  #
  ######  ##    #
           #####
