 #########
##       ##
# .#####  #
# .     # #
# O oo  # #
# O## ##  #
# O   #  ##
# O## # ##
# +   # #
# o###  #
##     ##
 #######
