 #### # ####
##  #   #  ##
#   #####   #
#  o. O .o  #
###.o.o.o.###
  # .o o. #
# #Oo @ oO# #
  # .o o. #
###.o.o.o.###
#  o. O .o  #
#   #####   #
##  #   #  ##
 #### # ####
