   #####
   #   #
#### # #
# . .# #
#  .   #
# .## o##
##  #oo #
 ##   o@#
  ##  ###
   ####
