       #####
       #   #
      ## # #
      # O  #
      # # ##
####### #  #
#   # .o.o.####
# #   oo.oo   ###
#  O##..@..##O  #
###   oo.oo   # #
  ####.o.o. #   #
     #  # #######
     ## # #
     #  O #
     # # ##
     #   #
     #####
