####
#  ###
#    #
# o  #
### ###
# o o #
#..@..#
#  o  #
###  ##
  ####
