 #########
 #   #   #
## # # # ##
# O.OoO.O #
#    #    #
### o@o ###
#    #    #
# O.OoO.O #
## # # # ##
 #   #   #
 #########
