###### ####
#    ###  #
# O     O #
## #OOO#  #
 #  O+O  ##
## #OoO# ##
#  # # #  #
#         #
#  ########
####
