  ########
  #      #
###O####.#
#    o o #
# #......###
# #o #     #
# #. #@# # #
# oo## #o# #
#  o   o   #
#  #########
####
