 ########
##      ##
# .####  #
# .    # #
# O oo # #
# O## #  #
# +   # ##
# o###  #
##     ##
 #######
