           #
 # ######## #
  #        #
 # Oo.o.oO #
 #  O###O  #
 # o#   #o #
 #.. .@. ..#
 # o#   #o #
 #  O###O  #
 # Oo.o.oO #
 #        #
# ######## #
 #
