#####
#  @####
#  o.  #
###o.# #
#  o.# #
# #o.  #
#    ###
######
