    #####
 ####   #
 #  oo# #
## O..o #
#@ .#.  #
# o..O ##
# #oo  #
#   ####
#####
