     ####
     #  ########
     #  .      #
     #  ### oo #
     # o#  # .o#
 #####  # . .#.######
 #  o.  #  # .    o #
 # o.#.###o###  o   #
 # o . #.   .#####.##
 #  # ## Ooo #   # #
 # # . o o@o o . # #
 # #   # ooO ## #  #
##.#####.   .# . o #
#   o  ###o###.#.o #
# o    . #  #  .o  #
######.#. . #  #####
     #o. #  #o #
     # oo ###  #
     #      .  #
     ########  #
            ####
