     #######
     #  @  #
     # ### ##
#### # # #  #####
#  ### # # .    #
# .    # # O oo #
# O oo # # O## ##
# O## ## # O   #
# .   #  # O## #
#  ####  # .   #
####     #  ####
         ####
