          ####
          #  #
          #  #
          #  #
############ #
#    o o.O oo#
# @  o..O.O. #
#   # O  o .o#
#####O.o   O.#
    #.O   o.O#
    #o. o  O #####
    # .O.O..o#   #
    #oo O.o o    #
    # ############
    #  #
    #  #
    #  #
    ####
