  ########
 ##  . . #
 # Oo# # #
 #.  #o# ##
##O #  #  #
#   # O   #
# o#@ .#  #
#     o ###
##  #   #
 ########
