                #######
       ###### ###     #
     ###    # #  oo##.#
 #####  o o ### #o ##.#
 # o o   #      #    .#
## # # o #  ### #  ## #
# o  o   #### #  ##   #
# o#.O##o #   ##    ###
#.O..... .#    ######
#  .#######
## @#
 #  #
 ####
