#### ####
#  ###  #
#  # oo #
# oo #  #
#    #  ##
### o.#  #
  #..O.@.#
  ##   ###
   #####
