#########
#       #    ######
#   o   ######    ###
# #o#o o o  # o     #
# o   o@o  o o o oo #
# o o# o #     ooo  #
#  o o #######   #####
##    ###....##### ..#
 ###oo# oooo #...O ..#
  #         ##   #.. #
  #  #  #o###....##O##
  #   ##..o. ....    #
  ### .O   .#....#   #
    ##################
