   ##### ####
   #@ .###  ###
####  oo o    #
#   # . . ##  #
#  o # . . ## #
## .  o oo  # #
 # #  ###.  # #
 # #### ##### #
 #       #    #
 ####### # ####
       # .o #
     ####   #
     ## #####
      ###
