#########
#. .    #
#.o. .  #
## ###@ #
 #  o  ##
 # oo ##
 #  o #
 #  ###
 ####
