   ###
  ## # ####
 ##  ###  #
## o      #
#   @o #  #
### o###  #
  #  #..  #
 ## ##.# ##
 #      ##
 #     ##
 #######
