   ####
  ##  #############
 ##    .......... #
##    #  ####o### ##
#      # #      #  ##
#     #  # ooo  # # #####
#####  # . .# ### . . . ##
    #   o. .#  # oo o o @#
   ####### ### #   #######
   # o   o   # ## ###
   #    o  o #  # ## # ####
   # o### ####  # # # ##  ####
   #  o ooo  # ## #  ##      #
   ##        # ## #### ooo   #
    ## ####### .....     #####
    #  o         ######  #
    #   ######  ##    ####
    #####    ####
