 #####
 #   #
## # #####
#    ##  #######
# #     o      ####
#   #### o  oo #  #
#####  # ooo o #o #
       # o  o o o ######
     ###o   #o o  o    #
     # o oo      ### @ ##
     #  o oooo####...   #
     #  o     o #. .#...#
     ### oooo   ......  #
       #      ##..#.....#
       ###### ##.....####
            #   .....#   #
            ##########
