 #######
##     # #
#  O.o.#
#  O.#.###
# #o@oo  #
#   ## # #
######   #
     #####
