         #####
     #####  #####
     #  .#o   o #
     # #. ooo @ ##
     #  .#o   o  #
     ###.#  o o  #
       #.  ##o ###
 #######O###.o #
 # o    ....####
## #o#oo....#
#  o o   #..#
#     o  #..#
#  ##########
#####
