####
#  #              ####
#  ######## #######  #
#         ###  ##  o #
##.###### ...     #. #
 #.#      # .#   # o #
 #oooo#ooo #.#   ##. #
 #.# o   o #..      ##
 #.#  o  o   # #   ##
 #  #   oo #   #####
 #.  ##o  ######
 #.   #  o.  #
##. @ ###.#o #
#     # #    #
#    ## ######
######
