 ## #####
## ## . #
# ## o. #
 ## o   #
## o@ ###
# o  ##
#.. ## ##
#   # ##
##### #
