           ######
    ####  ##    #
  ###  #  #  ## ###
###    #### #   o #
#  o @ ...O..  o  #
# o o  ## ###   ###
### ###   # #####
 #      ###
 #   ####
 #####
