   #####
   #   #
 ###   ########
##  OOO    # # #
 #  O O    ## # #####
##  OOO   ## # ##   ##
 ###   #### # # #   #
   #   # # # ####o o###
  ##   ## # ##  o...o ##
   ##### # ##    .@.  #
        # # #   o...o ##
         ########o o###
                #   #
                #####
