   #####
   #   #####
   # oo#   ######
 ###.  . o #    #
 #  .##.####### #
 # o.  . #    # #
##.##oooo#ooo ######
 #...    .    #    #
 #..##.####.### ##@#
 ## # o o o # o o  #
  # #       #     ###
  # #.##.#.######  #
  #  o # o.     o  #
  #    ###.## ###o##
  ###### #        #
         ##########
