   #######
 ###     ##
 #   ###  #
 #      # #
###o#@  # #
#   ##### #
#   #  O. #
##oo#  O.##
 #     O..#
 #### #...##
    # #ooo #
    #   o  #
    #####  #
        ####
