##### ########
#   ### . o  #
#   o O.. #o ##
## o# ..O o  @#
 #  o . ###   #
 ######## #####
