   # # # # # # # # # # # #
  # # # # # # # # # # # # #
 #   .o    . o.  . o   .o  #
  # o# #o# # # #o# # # #  #
 #  .  .    o.  .  .o .  . #
  # #o# # # # #o#o o# #o# #
 # .     .o .o    . o.  .  #
  # o# # # # #@# # # # #o #
 #  .  .o .    o. o.     . #
  # #o# #o o#o# # # # #o# #
 # .  . o.  .  .o    .  .  #
  #  # # # #o# # # #o# #o #
 #  o.   o .  .o .    o.   #
  # # # # # # # # # # # # #
   # # # # # # # # # # # # 
Title: Particle Theory
