              #####
              #   #
    #####     #   #######
    #   ##### #   ..... #
##### # ##  # #     # # #
# o o o o o # ##   ## o #
# # ##......#### ### oo ###
#      ## O #    # #  oo  #
##########+oo   ## #      #
         #.o o# #  ########
         #.##   #
         ########
