    #######
    #     ##
##### ###  ##
#       #  ##
#@oOOO. ##o #
#  #    ## .#
##  ##  # o #
 ##  ####.o.#
  ##        #
   ######  ##
        ####
