  ###########
 ##     #  @#
### o oo#   #
# ##o    oo #
#  #  o #   #
###### ######
#.. ..o #O##
# ..    ###
#  ..#####
#########
